vacillant|Empr. au lat. vacillare  « chanceler » au sens propre et fig. 
vacillation|Empr. au lat. vacillatio  « balancement », dér. de  vacillare  . 
vaciller|Empr. au lat. vacillare  « chanceler » au sens propre et fig. 
vacant|Empr. au lat. vacans , part. prés. de  vacare  « être vide, inoccupé », v.  vaquer. 
vacarme|Empr. de l'interj. m. néerl. wacharme!  « hélas! pauvre de moi! ». 
vagabond|Empr. au b. lat. vagabundus  « vagabond, errant », dér. du lat. class.  vagāri  « aller çà et là, errer », v. aussi  vaguer . 
vacuité|Empr. au lat. vacuitas  « espace vide », « absence de quelque chose », dér. de  vacuus  « vide, inoccupé ». 
vagabonde|Empr. au b. lat. vagabundus  « vagabond, errant », dér. du lat. class.  vagāri  « aller çà et là, errer », v. aussi  vaguer . 
valériane|Empr. au lat. médiév. valeriana  , d'apr. le lat.  Valeria  « province romaine de la Pannonie », anc. région située à peu près à l'emplacement actuel de la Hongrie, où cette plante était très répandue. 
vaigre|Empr. au néerl. weger , de même sens.
vagir|Empr. au lat. class. vagire  « vagir, crier ». 
vagissant|Empr. au lat. class. vagire  « vagir, crier ». 
vaillantie|Empr. au lat. sc. Valantia  ; puis  Vaillantia  ; dér. au moy. du suff.  -ia du nom du botaniste fr. Sébastien Vaillant [1669-1722].
valétudinaire|Empr. au lat. valetudinarius  adj. et subst. « malade ». 
vague|Empr. au lat. class. vagus  « vagabond, errant » ; puis « inconsistant, flottant, indéterminé, indéfini ». 
vaguer|Empr. au lat. class. vagāri  « errer, aller çà et là » lui-même dér. de  vagus  . 
valide|Empr. au lat. validus  « bien portant ». 
valider|Empr. au b. lat. validare  « fortifier , rétablir ». 
vanité|Empr. au lat. vanitas, -atis  « état de vide, de non réalité; vaine apparence, mensonge; tromperie, fraude; frivolité, légèreté; vanité, jactance ». Les premiers ex. du sens A, sont exclusivement empr. à la lang. chrét. . 
validité|Empr. au b. lat. validitas  « force , solidité  » avec infl. sém. de  valider *. 
valine|Empr. à l'all. Valin  , forgé sur  Valerian-Säure  désignant l'acide valérianique; l'angl.  valine  est att. également en 1907 .
valise|Empr. à l'ital. valigia  « petite malle » , du lat. médiév.  valisia  , d'orig. incertaine, peut-être dér. du rad. gaul. * val-  « entourer » . 
valkyrie|Empr. à l'a. nord. valkyrja ,  cf.  le dan.  valkyrie , le suéd.  valkyria , l'all.  Walküre , de même sens. 
valse|Empr. à l'all. Walzer , att. au sens 1 a dep. 1781 , dér. de  walzen , att. au sens de « danser en tournant » dep. 1760. Au sens 2 a,  cf.  l'angl.  hesitation waltz,  att. dep. 1914 ds  NED Suppl. <sup 2</sup . 
valve|Empr. au lat. valva  « battant de porte »  avant d'être repris par le lat. sc. dans des accept. spéc. . Au  xix <sup e</sup s., sans doute sous l'infl. de  valvule *, le mot entre dans la terminol. de la mécan. . 
valvule|Empr. au lat. sc. valvula , dimin. de  valva  . Au  xix <sup e</sup s. le mot entre dans la terminol. de la mécan. . Le lat. class. ne connaît  valvula qu'au sens de « gousse », d'où 2 a. Dans la 2<sup e</sup moit. du  xviii <sup e</sup s.,  valvule  a été introd. par J.-J. Rousseau dans la terminol. de la bot. comme dimin. de  valve *. 
vamp|Empr. à l'anglo-amér. vamp , abrév. de l'angl.  vampire  corresp. au fr.  vampire *. L'angl.  vampire,  qui était empl. p. anal. pour désigner une personne se livrant au harassement et à l'exploitation des autres ou à diverses extorsions , a servi à désigner une femme usant de ses pouvoirs de séduction pour exploiter les hommes , d'où son empl. pour désigner un rôle cinématographique représentant ce type de personnage féminin  et, p. ext. une actrice propre à l'interpréter, comme  Theda Bara  dont le rôle dans le film  A Fool there was tiré de la nouv. de Rudyard Kipling  The Vamp  est peut-être à l'orig. de la propagation du terme . 
variété|Empr. au lat. varietas  « variété, diversité », propre et fig. « changement d'humeur, inconstance ». 
variole|Empr. au b. lat. méd. variola  « maladie infectieuse » , dimin. de  varius  « ayant la petite vérole » , avec infl. du lat.  varius  « varié, bigarré, tacheté, moucheté ». 
variable|Empr. au lat. variabilis  « variable, changeant ». 
vaquer|Empr. au lat. vacare  « être libre, inoccupé, vacant; être inoccupé, oisif; [+ datif, ou  in  + acc.] avoir des loisirs pour, s'occuper de ». 
variance|Empr. au lat. variantia  « variété », 2 et 3 certainement dér. de  -variant , élém. de compos. dans des termes comme  invariant *,  covariant *; suff.  -ance *.
varan|Empr. à l'ar. waran , var. de  waral  « varan » . Lat. sc.  varanus  . L'a. fr.  varain ne peut convenir ici, puisqu'il s'agit en fait non pas d'une sorte de crocodile, comme le définir  Gdf. , mais d'un loup;  cf.  R.  Arveiller ,  op. cit. , p. 87.
varangue|Empr. à l'a. nord. [  v ] rong  « pièce de bois courbe servant à renforcer la coque d'un bateau », dont la voy. était anciennement  -a- , ou dont le  -o-  a été perçu comme un  -a-  lors de l'empr. Voir  FEW  t. 17, p. 437b. 
variation|Empr. au lat. variatio  « action de varier », « sorte de figure par laquelle on change les régimes en répétant le même verbe ». 
variqueux|Empr. au lat. varicosus  « qui a des varices, variqueux ». 
varice|Empr. au lat. varix, -icis  « varice ». 
varlope|Empr. au néerl. voorloper , de même sens que le français. 
vapeur|Empr. au lat. vapor  subst. masc. « vapeur d'eau, exhalaison, fumée », dans la lang. de l'époque impériale « chaleur », au fig. « bouffées de chaleur » et « état d'excitation  », att. au sens de « vanité » chez les aut. chrét. ; en fr.  vapeur  a été fait fém. p. anal. avec les termes en  -eur *. Pour désigner les nouv. machines utilisant la force motrice de la vapeur d'eau, il y eut fin  xviii <sup e</sup -déb.  xix <sup e</sup s. une période d'hésitation pendant laquelle coexistèrent des périphrases , le type à feu  , et le syntagme  à vapeur  qui devait l'emporter ;  à vapeur  corresp. aux dénom. angl. dans lesquelles  steam  « vapeur » entre en compos. avec le nom de l'engin:  steamengine  1751  pour désigner un engin mû par la vapeur, 1815 au sens de « locomotive »,  steamboat  dep. 1787 ,  cf. steamcarriage  rendu par « chariot à vapeur » 1815 et  steamhorse  par « cheval de vapeur » 1821 . 
vare|Empr. à l'esp. vara , att. comme nom d'une mesure de longueur dep. le  xiv <sup e</sup s. , d'abord « baguette; bâton » dep. 1250 , du lat. d'époque impériale  vara  « traverse de bois » . 
varié|Empr. au lat. variatus  « nuancé », part. passé adj. de  variare  . 
vaporeux|Empr. au lat. vaporosus  « plein de vapeurs ». 
varier|Empr. au lat. variare  « varier, diversifier, nuancer », fig. « mettre de la variété dans le style », intrans. « être varié, différer ». 
varve|Empr. au suéd. varv  « couche ».
vase|Empr. au lat. vas, vasis , att. au sens 2 a; 1 a empr. au lat. chrét.  vas electionis  . On trouve plus anciennement  vaissel d'election  .  Cf.  aussi  vasses  plur. « récipient » ). 
vasque|Empr. à l'ital. vasca , att. au sens 1 dep. la 1<sup re</sup moit. du  xvi <sup e</sup s. , issu du lat. pop.  vascula , encore vivant dans les dial. d'Italie du Sud dans la terminol. de la vitic., fém. tiré au plur. neutre du lat.  vasculum  « petit récipient » . 
vaticinant|Empr. au lat. vaticinari  « prophétiser », dér. de  vates  « devin, prophète ». 
vecteur|Empr. au lat. vectŏr, -ōris  « celui qui transporte », dér. de  vehĕre  « transporter, porter ». Pour le sens B le terme a été introd. par l'intermédiaire de l'angl.  vector  utilisé en math.  d'apr. son usage en astron. . 
vaticinateur|Empr. au lat. vaticinator  « devin, prophète », dér. de  vaticinari  .
vaticination|Empr. au lat. vaticinatio  « action de prédire l'avenir », « oracle, prophétie », dér. de  vaticinari  . 
vaticinatrice|Empr. au lat. vaticinator  « devin, prophète », dér. de  vaticinari  .
vaudou|Empr. à vodu , mot d'une lang. d'Afrique Occidentale . 
vaticiner|Empr. au lat. vaticinari  « prophétiser », dér. de  vates  « devin, prophète ». 
vaste|Empr. au lat. vastus  « vide, désert »; « désolé, dévasté »; « prodigieusement grand », qui influencé par l'a. b. frq.  *wōst a donné en a. fr. l'adj.  gast  « désert, inculte ». 
veda|Empr. au skr. veda  « connaissance, science », en partic. « science sacrée, textes sacrés, Saintes Écritures, Veda », dér. de la racine  vid  « savoir, connaître, comprendre, apprendre », apparentée au lat.  videre  « voir », à l'all.  wissen  « savoir », etc. La forme  Bet  représente un empr. à une lang. mod. de l'Inde . 
véda|Empr. au skr. veda  « connaissance, science », en partic. « science sacrée, textes sacrés, Saintes Écritures, Veda », dér. de la racine  vid  « savoir, connaître, comprendre, apprendre », apparentée au lat.  videre  « voir », à l'all.  wissen  « savoir », etc. La forme  Bet  représente un empr. à une lang. mod. de l'Inde . 
vedanta|Empr. au skr. vedânta , propr. « fin du Veda », comp. de  Veda  et de  anta  « fin ».
vedette|Empr. à l'ital. vedetta , att. au sens 1 dep. déb.  xvi <sup e</sup s. , altér., sous l'infl. de  vedere  « voir », de  veletta  « lieu de guet élevé » , d'orig. incertaine. Un dér. dimin. de  vela  « voile »  fait difficulté parce que  veletta  « petite voile au sommet du mât principal d'un navire, à la hune, où se tient un marin dont le rôle est de surveiller l'horizon » n'est pas att. av. 1880. Un empr. à l'esp.  veleta  « gonfanon » , « girouette »  n'est pas non plus satisfaisant parce que le sens originel du mot ital. appartient au domaine de la mar. et que l'esp.  veleta  est lui-même d'orig. controversée. Voir  FEW  t. 14, pp. 223b-224; G.  Colón  ds  Z. rom. Philol.  t. 78, pp. 92-94;  Cor. - Pasc. ,  s.v. veleta. 
vélaire|Empr. au lat. sc. velaris , dér. de  velum « voile  » .
vélanède|Empr. au gr. mod. β ε λ α ν ι ́ δ ι « gland » , β α λ α ν ι ́ δ ι même sens  et β α λ α ν ι δ ι α ́ « chêne »  d'où le lat. médiév. valanidia  ; du gr. class. β α ́ λ α ν ο ς « gland; chêne » . La forme  avelanède  est prob. due à une confusion avec le mot prov.  avelanedo  « coudraie » .
véhémence|Empr. au lat. d'époque impériale vehementia  « véhémence d'un orateur; force, intensité  », dér. de  vehemens , v.  véhément . 
végétal|Empr. au lat. médiév. vegetalis  , dér. de  vegetare  . 
véhément|Empr. au lat. class. vehemens  « emporté, impétueux; violent, intense ». 
véhicule|Empr. au lat. class. vĕhĭcŭlum  « moyen de transport, voiture, chariot » . 
vehme|Empr. à l'all. Feme, Femgericht  « tribunal secret », d'orig. incertaine . 
velche|Empr. à l'all. welsch , nom donné par les Allemands aux Espagnols, aux Italiens et aux Français, et par les Suisses de lang. aléman. aux Suisses romands;  welsch  remonte au m. h. all.  wälhisch , dér. de  Walch , a. h. all.  Walh  « Roman », de la famille du germ.  *Walhoz  « Celtes », empr. au lat.  Volcae , nom d'une peuplade celte voisine des Romains. V. aussi  wallon. 
veld|Empr. à l'afrikaans veld , de même sens, propr. « champ ».
végétarien|Empr. à l'angl. vegetarian , subst. att. dep. 1839  et adj. dep. 1849  dér de  vegetable  « plante, légume » par substitution de la finale  -arian  de noms de sectes, écoles théol. ou mor. comme  Millenarian, Predestinarian , ou  Unitarian  . 
veillaque|Empr. à l'ital. vigliacco  « vil, digne du plus grand mépris » , lui-même empr.  à l'esp.  bellaco  « coquin, méchant », att. dep. la 1<sup re</sup moit. du  xiii <sup e</sup s. , prob. dér. de  vello  « duvet », du lat.  villus  « poil ». Voir L.  Spitzer  ds  R. Filol. esp.  t. 12, pp. 230-232 et  FEW  t. 14, p. 458. 
végétarienne|Empr. à l'angl. vegetarian , subst. att. dep. 1839  et adj. dep. 1849  dér de  vegetable  « plante, légume » par substitution de la finale  -arian  de noms de sectes, écoles théol. ou mor. comme  Millenarian, Predestinarian , ou  Unitarian  . 
végétatif|Empr. au lat. médiév. vegetativus  « qui fait végéter » , dér. de  vegetare , v.  végéter . 
végétation|Empr. au lat. médiév. vegetatio  « action de croître  », spécialisation du lat. class. « mouvement, excitation », dér. de  vegetare  . 
veinule|Empr. au lat. d'époque impériale venula  «  id.  », dimin. de  vena , v.  veine . 
végéter|Empr. au lat. tardif vegetare  « animer, vivifier, faire croître », « fortifier, vivifier  », « vivre, grandir  » ; dér. de  vegetus  « bien vivant, vif, dispos », dér. de  vegere  « être vif ». 
velvet|Empr. à l'angl. velvet  désignant le velours de soie et empl. en fr. pour désigner le velours de coton imitant le velours de soie. Att. dep. le  xiv <sup e</sup s. mais d'abord représenté par le lat. médiév. du domaine angl.  velvetum  , l'angl.  velvet  est prob. le résultat d'un empr. à l'a. fr. selon une forme suffixée en  -et  corresp. aux formes att. telles que p. ex.  veluau  « velours » ,  velvel ou  velvot dér. de  velu * avec confusion de  u  et  v  à la lecture .
velléité|Empr. au lat. scolast. velleitas  « velléité » , dér. au moy. du suff.  -itas de  velle- , rad. des formes de l'imp. du subj.  du verbe  velle  « vouloir ». 
venaison|Empr. au lat. venatio, -onis  « chasse; produit de la chasse, gibier ». 
velte|Empr. au néerl. viertel  ou à l'all.  Viertel  « quart  ». Voir  FEW ,  loc. cit . 
ventral|Empr. au lat. ventralis  « de ventre, du ventre ». 
ventilateur|Empr. à l'angl. ventilator , nom que donna à son invention S. Hales en 1743, calque du lat.  ventilator  « vanneur » . 
ventiler|Empr. au lat. ventilare  « agiter à l'air », « éventer, donner de l'air, de la fraîcheur à », en lat. jur. « discuter, débattre, examiner une question ». 
ventouse|Empr. au lat. méd. de basse époque ventosa , abrév. de  ventosa cucurbita  , littéral. « courge pleine de vent ».
verbeux|Empr. au lat. verbosus  «  id.  », dér. de  verbum  . 
ventriloque|Empr. au b. lat. ventriloquus  « qui parle du ventre ». 
verbosité|Empr. au b. lat. verbositas, -atis  « bavardage; discours verbeux » dér. de  verbosus  .
verbal|Empr. au b. lat. gramm. verbalis  « dérivé d'un verbe »  iv <sup e</sup s. ds  Gaff ., et « de paroles » fin  v <sup e</sup s.,  ibid. , dér. de  verbum  . 
verbe|Empr. au lat. verbum, -i  « mot », « parole », également att. comme terme de gramm., trad. du gr. ρ ̔ η ̃ μ α propr. « parole », « verbe » p. oppos. à ο ́ ν ο μ α « nom »; aux sens 2 et 3 empr. au lat. eccl.  verbum  de mêmes sens , le dernier sens étant repris au gr. λ ο ́ γ ο ς « verbe divin », « raison divine ». 
verdict|Empr. à l'angl. verdit, verdict  « décision d'un jury appelé à juger d'un cas relevant de la jurisprudence civile ou criminelle »  d'où, p. ext. « décision d'un corps ou d'une autorité amenée à prononcer un jugement » et « décision, avis donné sur un sujet quelconque » . L'angl.  verdit , empr. à l'anglo-norm.  verdit a été refait sous la forme  verdict  d'après le lat. médiév.  verdictum , var. de  verumdictum, veredictum  « procédure d'établissement d'une sentence, déclaration solennelle, verdict d'un jury » . 
vergobret|Empr. au lat. de César vergobretus  « premier magistrat des Éduens », mot celt., comp. de  vergo-  « efficace, qui accomplit »  et de breto-irl.  breth  « jugement », v.  Dottin , p. 66 et p. 124.
vermicelle|Empr. à l'ital. vermicelli  « pâtes en forme de longs fils très minces » , plur. de  vermicello , propr. « petit ver », dér. dimin. de  verme  « ver », du lat.  vermis  «  id.  ». Voir  FEW  t. 14, pp. 296b-297a. 
vermicule|Empr. au lat. vermiculus  « petit ver, vermisseau », dimin. de  vermis  « ver ». Au sens 1 b,  cf.  lat. sc.  vermiculum  . 
vermiculé|Empr. au lat. vermiculatus « en forme de ver ; vermiculé  », lat. médiév., comme terme d'orfèvr. . 
vernal|Empr. au lat. vernalis  « relatif au printemps », dér. de  vernus  « printanier », lui-même dér. de  ver, veris  « le printemps ».
vernation|Empr. au lat. des botanistes vernatio  « disposition des feuilles dans le bourgeon, avant leur développement » , lat. class  vernatio  « mue  au printemps; mue en général », dér. de  vernus  « printanier » .  Vernation  est att. en angl. dès 1793 .
verrucaire|Empr. au lat.  verrucaria  « herbe qui guérit les verrues ».
verruqueux|Empr. au lat. verrucosus  « qui a une verrue », dér. de  verruca  . 
vermination|Empr. au lat. verminatio  « maladie des vers », dér. de  verminare  « avoir des vers ».
versatile|Empr. au lat. versatilis  « mobile, qui tourne aisément » et fig. « flexible, qui se plie à tout » . 
vermouth|Empr. à l'all. Wermut  « absinthe » , « vermouth », d'orig. obscure. 
vertige|Empr. au lat. vertigo  « mouvement de rotation, tournoiement », « vertige, étourdissement, éblouissement » de  vertere  « tourner », « retourner, renverser », « changer, convertir, transformer ». 
vertigineux|Empr. au lat. vertiginosus  « sujet aux vertiges, aux étourdissements ». 
versicolore|Empr. au lat. versicolor  « qui a des couleurs changeantes » . 
vertèbre|Empr. au lat. vertebra  « articulation; vertèbre ». 
versifiant|Empr. au lat. versificare  « écrire en vers, tourner en vers ». 
versificateur|Empr. au lat. versificator  « celui qui écrit des vers, qui tourne en vers », empl. par Quintilien, p. oppos. à  poeta  « poète » , avec une nuance péj. à laquelle fait réf.  Du Bellay ,  loc. cit. ; l'anc. lang. employait également  versefieur ,  versifieur  att. du déb. du  xiii <sup e</sup s. au  xv <sup e</sup s. , repris dans la lexicogr. de  Boiste  1800 à  Guérin Suppl.  1895. Sur la dissociation sém.  versificateur / poète , v. P.  Zumthor ,  Neophilologus , t. 39, p. 248. 
versification|Empr. au lat. versificatio  « action de composer des vers » ;  cf.  une attest. isolée de  versification  au sens de « poème » . 
versifier|Empr. au lat. versificare  « écrire en vers, tourner en vers ». 
version|Empr. au lat. médiév. versio  « changement, transformation » , « action de tourner, de retourner » , « traduction » , v.  Latham , dér. de  versum  supin de  vertere  « tourner, faire tourner, se tourner, changer, transformer » et « faire passer d'une langue dans une autre, traduire ». 
vertical|Empr. au lat. verticalis  « vertical », dér. de  vertex, verticis  « sommet ». 
verticale|Empr. au lat. verticalis  « vertical », dér. de  vertex, verticis  « sommet ». 
verste|Empr. au russe verstá  « mesure itinéraire valant 1 067 mètres », a. russe « mesure de longueur », apparenté au lat.  vorsus, versus  « ligne »,  cf. Vasmer . 
verticille|Empr. au lat. verticillus  « peson de fuseau ».  Cf. Tournefort ,  loc. cit. : ,,Ces sortes de plantes s'apellent verticillées du mot Latin  verticillus , qui est un petit poids percé d'un trou où l'on engage le bas d'un fuseau à filer, afin de le faire tourner avec plus de facilité. Les tiges des plantes verticillées ressemblent assez à des fuseaux qui seroient garnis dans leur longueur de plusieurs de ces poids``. 
vespertilion|Empr. au lat. vespertillio, -onis  « chauve-souris ».
vestige|Empr. au lat. vestigium , propr. « trace du pied », d'où en gén. « trace ». 
veuglaire|Empr. au m. néerl. vogelaer , de même sens que le français.
vessigon|Empr. à l'ital. du Nord vescicone  « enflure au jarret du cheval » , propr. « grosse vessie », dér. de  vescica  « vessie », issu du lat.  vēsīca  avec infl. du lat. tardif  vissīre  « vesser » . Voir  FEW  t. 14, p. 342b. 
vestale|Empr. au lat. vestalis  adj. « de Vesta » [ Vestalis virgo ,  Tite Live ], subst. « prêtresse de Vesta ». 
vespéral|Empr. au b. lat. vesperalis  astron. « du couchant » . Au sens A,  vesperalis  semble moderne. 
veste|Empr. à l'ital. veste  « vêtement; élément de l'habillement » , du lat.  vestis , acc.  veste  «  id.  ». Voir  FEW  t. 14, pp. 356b-357a. 
vespérie|Empr. au lat. ecclés. vesperia , sens 1 a, s.d. ds  Blaise Latin. Med. Aev. ; 1328,  Nicolas Trivet  ds  Du Cange .
vibraphone|Empr. à l'angl. vibraphone formé sur les syll.  vibra-  de  vibration  ou  vibrato  avec l'élém. corresp. au fr.  -phone *.
vexateur|Empr. au lat. vexator  « persécuteur, bourreau; celui qui pourchasse », dér. de  vexare  . 
vexation|Empr. au lat. vexatio  « agitation violente », au fig. « mal, tourment »; « mauvais traitement, persécution », dér. de  vexare  . 
vexatrice|Empr. au lat. vexator  « persécuteur, bourreau; celui qui pourchasse », dér. de  vexare  . 
vibration|Empr. deux fois au lat. tardif vibratio  « action de brandir », « action d'agiter  », dér. de  vibrare  . 
vexer|Empr. au lat. vexare  « secouer; tourmenter, persécuter; malmener en paroles » intensif de  vehere  « transporter; charrier ». 
vexillaire|Empr. au lat. vexillarius  « porte-enseigne », dér. de  vexillum  .
vicaire|Empr. au lat. class. vicarius  « remplaçant » d'où en lat. chrét. « remplaçant d'un préfet du prétoire » et en lat. médiév. « titre que portaient des fonctionnaires chargés de l'administration », d'où le sens 1; dès le lat. chrét.  vicarius Christi  « vicaire du Christ », titre appliqué au pape pour la première fois au  v <sup e</sup s. , puis en lat. médiév., désigne le prêtre qui aide et remplace éventuellement le curé;  vicarius  est dér. de  vicis , forme de génitif « tour, succession, alternative », v. l'élém. formant  vice- *; v. aussi  viguier . 
vexille|Empr. au lat. vexillum  « étendard, drapeau », dimin. de  velum  « voile, toile, tenture ».
vexillum|Empr. au lat. vexillum  « étendard, drapeau », dimin. de  velum  « voile, toile, tenture ».
vibrer|Empr. deux fois au lat. vibrare , trans. « brandir; imprimer un mouvement vibratoire à quelque chose; lancer » , intrans. « avoir des vibrations, des tremblements; vibrer [en parlant des sons] » . 
viatique|Empr. au lat. viaticum  « provisions de voyage; argent pour le voyage », neutre subst. de l'adj.  viaticus  « du voyage » , dér. de  via  « voie, route, chemin »; « marche, voyage ». 
vice|Empr. au lat. vitium  « défaut, imperfection, tare; défaut physique, difformité, infirmité; défaut , vice ». 
vibord|Empr. à un mot dan. ou norv., cf.  l'a. nord.  vígi  « bastingage, plat-bord »; la 2<sup e</sup part. du mot représente  bord *, sans qu'il ne soit possible de dire si le mot existait déjà comme comp. en a. nord. ou si la compos. s'est faite plus tard.  FEW  t. 17, p. 428b.
vibrisse|Empr. au b. lat. vibrissae  « poils du nez ».
victimaire|Empr. au lat. victimarius  « victimaire, ministre des autels qui préparait tout pour le sacrifice; marchand d'animaux destinés au sacrifice », dér. de  victima  .
victime|Empr. au lat. victima  « victime, animal destiné au sacrifice », lat. chrét., p. méton. « égorgement, immolation; sacrifice » , d'où le sens A. 
victimé|Empr. au lat. d'époque impériale victimare  « égorger ou sacrifier  », dér. de  victima  . 
victimer|Empr. au lat. d'époque impériale victimare  « égorger ou sacrifier  », dér. de  victima  . 
victoire|Empr. au lat. victoria  « victoire ; succès, triomphe; la déesse Victoire, statue de la Victoire »; dér. de  victor  « vainqueur », et celui-ci de  vincere  . 
vicié|Empr. au lat. vitiare  « rendre défectueux, gâter, corrompre, altérer; déshonorer; frapper de nullité; falsifier »; dér. de  vitium  . 
vicier|Empr. au lat. vitiare  « rendre défectueux, gâter, corrompre, altérer; déshonorer; frapper de nullité; falsifier »; dér. de  vitium  . 
victorieux|Empr. au b. lat. victoriosus  « victorieux », dér. de  victoria  . 
vicieux|Empr. au lat. vitiosus  « gâté, corrompu; défectueux, mauvais, entaché de vice, irrégulier », dér. de  vitium  . 
vicinal|Empr. au lat. vicinalis  « de voisinage, voisin; vicinal », en partic.  via vicinalis  « voie vicinale  », dér. de  vicinus  .  Cf.  m. fr.  voisinal  . 
vicissitude|Empr. au lat. class. vicissitudo  « alternative, échange, passage successif d'un état dans un autre »  cf. fortunae vicissitudines  « les vicissitudes de la fortune » chez Cicéron; dér. de  vicis  forme du génitif « tour, succession »,  cf.  l'élém. formant  vice- *. 
vicennal|Empr. au b. lat. vicennalis  « qui a lieu tous les vingt ans » d'où le subst. plur.  vicennalia  « fête célébrée après vingt ans de règne d'un empereur », de  vicennium  « espace de vingt ans », comp. de  vicies  « vingt fois » et de  annalis  « relatif à l'année », dér. de  annus , v.  an .
vicomte|Empr. au lat. médiév. vicecomes  « délégué permanent du comte, exerçant ses fonctions dans l'ensemble du comté » , comp. de  vice- et  comes sur le modèle du lat. médiév.  vicedominus  att. au  vi <sup e</sup s. . 
vidrecome|Empr. à l'all. wiederkommen  « revenir ». 
viduité|Empr. au lat. viduitas, -atis  « privation; viduité »;  cf.  le synon. de formation pop. a. fr.  veveé  , et de là, par substitution du suff.  -eté − et malgré l'écart chronol. des ex. −  veuveté  . 
vidéotex|Empr. à l'angl., usité surtout en Amérique du Nord videotex comp. de  video et de  tex  d'apr. le nom de marque déposé  teletex  désignant un réseau télématique. 
vidéo|Empr. à l'angl. video  formé sur le lat.  vidēre  « voir » d'apr.  audio- att. dep. 1935 en empl. adj. et dep. 1937 comme subst., notamment au sens gén. de « télévision », puis au sens partic. de « appareil d'enregistrement d'images de télévision »  puis « enregistrement d'images de télévision »  p. abrév. de  video recorder  et  video recording  d'où « production et utilisation d'enregistrements télévisuels »  v.  NED Suppl. <sup 2</sup La var. de genre est due sans doute aux empl. qui représentent l'abrév. de syntagmes tels que  signal vidéo , masc. et  vidéo fréquence  ou  bande vidéo , fém. 
vidicon|Empr. à l'angl. vidicon  , comp. de  vid-  de  video et de  icon-  de  iconoscope  . 
vigogne|Empr. à l'esp. vicuña  « ruminant péruvien du genre lama », att. dep. 1554 , lui-même empr. au quichua  vikuña  «  id.  ».  FEW  t. 20, p. 84a. 
vilipender|Empr. au lat. médiév. vilipendere  « dénigrer » 1090 ds  Latham , part. prés.  vilipendens  att. dès 864 , comp. de  vilis  « vil » et  pendere  « peser, estimer ». 
vigueur|Empr. au lat. vigor  « énergie physique ou mentale, vie, vitalité » et dans le domaine jur. « force, validité » . 
viking|Empr. à une lang. scand. . 
vigilance|Empr. au lat. vigilantia  « habitude de veiller, soin vigilant, attention », dér. de  vigilare  . 
vigilant|Empr. au lat. vigilans  « attentif, soigneux », part. prés. adj. de  vigilare  « veiller ». 
vigile|Empr. au lat eccl. vigilia  « veillée religieuse ». 
villanelle|Empr. à l'ital. villanella  « petite chanson paysanne » , dér. de  villano  « paysan » . 
vilayet|Empr. au turc vilâyet  « province, préfecture », et celui-ci à l'ar.  wilāya  « préfecture, gouvernement, administration , province », dér. de  waliya  « être préposé à quelque chose; gouverner, régir, administrer » .
vierge|Empr. au lat. virgo, -inis  « jeune fille, vierge », en appos.  virgo filia  « fille vierge »; désigne spéc. les Vestales , Diane ; terme de cosmographie « constellation de la Vierge » ; fig. en appos. « vierge, qui n'a pas encore servi » . Le développement sém. du mot se fait en rel. avec la théol. chrét., notamment en parlant du Christ et de sa Mère,  cf. iv <sup e</sup s.,  Hier. ,  Iov. , 2, 8:  ille  [ Christus ]  virgo de virgine; Virgo immaculata  « la Vierge Marie » .  Virginem  a été rendu par  virgene , puis  virge  par élimination de la syll. finale; devenu  vierge  par développement de  e  entre  i  et  r  suivi de cons. . 
villégiature|Empr. à l'ital. villeggiatura  « séjour à la campagne » , dér. de  villeggiare  « séjourner dans sa maison de campagne pour s'y reposer ou s'y divertir », dér. de  villa  . 
villeux|Empr. au lat. villosus  « velu, couvert de poils », dér. de  villus  « poil ».
vincible|Empr. au lat. vincibilis  « qu'on peut vaincre; qui peut vaincre », dér. de  vincere  « vaincre » .
vinculer|Empr. au lat. vinculare  « enchaîner », dér. de  vinculum  « lien ». 
vindicte|Empr. au lat. vindicta  « baguette dont on touchait l'esclave que l'on voulait affranchir; action de revendiquer; vengeance; punition », dér. de  vindicare , v.  vindicatif . 
vinifère|Empr. au lat. vinifer  « qui produit du vin ».
violateur|Empr. au lat. violator  « celui qui porte atteinte à », « profanateur », dér. de  violare  . 
vineux|Empr. au lat. vinosus  « adonné au vin, pris de vin », « qui rappelle le vin ». 
violation|Empr. au lat. violatio  « profanation », « violation de parole », dér. de  violare , v.  violer . 
violatrice|Empr. au lat. violator  « celui qui porte atteinte à », « profanateur », dér. de  violare  . 
viole|Empr. à l'a. prov. viola  « viole » , lui-même issu d'un b. lat. * viola  , d'orig. discutée , peut-être onomat. Se substitue à partir du  xv <sup e</sup s. à  vielle *, dont il ne paraît être à l'orig. qu'un substitut particulièrement fréq. à la rime, quand l'instrument est devenu désuet ou provincial et que le mot  vielle , surtout utilisé dans des expr. péj. , n'a plus désigné que la vielle à roue . 
vinosité|Empr. au lat. vinositas  « suc vineux ».
vinaire|Empr. au lat. vinarius  subst. « marchand de vin » et adj. « relatif au vin ».
vintage|Empr. à l'angl. vintage , issu d'une forme altérée de l'a. fr. corresp. au fr. mod.  vendange * et désignant la récolte de raisin ou le vin d'une saison  puis un vin remarquable par sa qualité, spéc. en réf. à un âge ou à un millésime . Empl. en appos., il qualifie un vin millésimé de grande qualité, comme dans le syntagme  vintage Port  désignant un vin de  Porto . 
violence|Empr. au lat. violentia  « caractère violent, emporté », « force violence », dér. de  violentus , v.  violent . 
violent|Empr. au lat. violentus  « emporté  », « impétueux  », dér. de  vis  « force, vigueur ». 
virgule|Empr. au lat. class. virgula  « petite baguette, petite verge », à cause de la forme de la virgule. 
viride|Empr. au lat. class. viridis  « vert, verdoyant », dér. de  virere  « être vert ». 
violer|Empr. au lat. violare  « traiter avec violence », « violer », « profaner, outrager », dér. de  vis  « force, violence ». 
viridité|Empr. au lat. class. viriditas  « la verdure, le vert », dér. de  viridis , v.  viride .
vip|Empr. à l'angl. V.I.P., VIP , init. de  very important person  « personne très importante », att. sous les formes inv.  V.I.P.  puis  VIP  dep. 1933 et plus rarement  Vip , plur.  Vips , dep. 1945 ds  NED Suppl. <sup 2</sup 
vireuse|Empr. au lat. virosus  « d'odeur fétide, infect », dér. de  virus  .
viril|Empr. au lat. class. virilis  « d'homme, de mâle; fort, vigoureux », dér. de  vir  « homme ». 
vipère|Empr. au lat. vipera  « vipère, serpent », empl. aussi comme terme d'injure. La forme  vipère  a éliminé la forme  guivre *. 
vireux|Empr. au lat. virosus  « d'odeur fétide, infect », dér. de  virus  .
vipérin|Empr. au lat. viperinus  « de vipère; de serpent », dér. de  vipera  « vipère ». 
vipérine|Empr. au lat. viperinus  « de vipère; de serpent », dér. de  vipera  « vipère ». 
virgilien|Empr. au lat. d'époque impériale Virgilianus  « virgilien, de Virgile », dér. du nom de  Virgilius Maro , poète lat. ; le sens 1 est la trad. du lat.  Virgilianae sortes  « divination par les vers de Virgile » . 
virilité|Empr. au lat. d'époque impériale virilitas  « âge viril; sexe de l'homme, caractère mâle », dér. de  virilis , v.  viril . 
virginal|Empr. au lat. virginalis  « de vierge, de jeune fille ». 
virginale|Empr. au lat. virginalis  « de vierge, de jeune fille ». 
violoncelle|Empr. à l'ital. violoncello , att. comme nom d'un instrument de mus. à cordes dep. 1665 , dér., avec suff. dimin., de  violone  « contrebasse », lui-même dér., avec suff. augm., de  viola  « viole », empr. à l'a. prov.  viola  . 
virole|Empr. au lat. viriola  « sorte de bracelet », dér. de  viria , même sens, mot d'orig. celt. . 
virginité|Empr. au lat. virginitas, -atis  « état d'une personne vierge ». 
visigothe|Empr. au b. lat. Wisigothae, Wisigothi  , comp. de  Gothi  « Goths » et de  Visi  « Wisigoths », qui appartient à une famille i.-e. signifiant « bon, noble »; les Wisigoths sont les « Goths nobles ». Voir M.  Schönfeld ,  Wörterbuch der altgermanischen Personen- und Völkernamen , pp. 267-268. 
visiter|Empr. au lat. visitare  propr. « voir souvent », « visiter, venir voir quelqu'un »; dans la lang. chrét. « visiter [œuvre pie] » , «  visiter, apparaître pour secourir » , «  pour juger, éprouver, châtier » ; « visiter, inspecter » .  Cf.  la forme pop. a. fr.  visder  . 
viscère|Empr. au lat. viscera , plur. de  viscus, -eris  « parties internes du corps, intestins, entrailles ». 
virtuel|Empr. au lat. médiév. et scolast. virtualis  « virtuel, potentiel » , dér. du lat. class.  virtus  . En angl.  virtual  est att. dès 1398 sous la forme  vertual  ; en opt. 1704  virtual focus , 1831  virtual image  ; en phys. atom. 1931  virtual level et en informat. 1959  virtual memory  . 
viscose|Empr. à l'angl. viscose  , mot créé en 1892 par les chimistes angl. Ch. F. Cross et E.-J. Bevan, inventeurs de cette substance , à partir du rad. du lat.  viscum  « gui »  ou de l'angl.  viscous  « visqueux »; suff.  -ose  .
vision|Empr. au lat. visio  « action de voir, vue », « ce qui se présente à la vue, image, simulacre des choses », « action de voir par l'esprit, de concevoir », « idée perçue, conception, point de vue ». 
virtuose|Empr. à l'ital. virtuoso  « celui qui connaît parfaitement un art, une science, etc., et qui en use avec une absolue maîtrise » , d'abord adj. « qui pratique le bien, la vertu » , dér. de  virtù  « vertu », empr. au lat.  virtus, -utis  .  Cf.  la forme ital.  virtuoso , att. en fr. de 1654  à 1755 . 
viscosité|Empr. au lat. médiév. viscositas  « état de ce qui est visqueux », dér. du b. lat.  viscosus  . Au sens A 2 et 3,  cf.  angl.  viscosity  . 
visqueux|Empr. au b. lat. viscosus  « englué, enduit de glu; visqueux, gluant », dér. de  viscum  « gui ». 
virulence|Empr. au b. lat. et lat. chrét. virulentia  « mauvaise odeur, infection »; fig. « poison  » , dér. de  virulentus  . Au sens 2,  cf.  angl.  virulency  ,  virulence  . 
virulent|Empr. au b. lat. virulentus  « venimeux  » et au fig. « corrosif, virulent  » dér. de  virus  . Au sens 2 b et c, prob. empr. à l'angl.  virulent , att. dans ces sens dep. le déb. du  xvii <sup e</sup s. . 
visualisation|Empr. à l'angl. visualization  ; v.  Rey - Gagnon Anglic.  1981. 
visibilité|Empr. au b. lat. visibilitas  « qualité d'une chose visible », du lat.  visibilis  . 
visualiser|Empr. à l'angl. to visualize  , de  visual  « visuel » . 
visible|Empr. au lat. visibilis  « visible », « qui a la faculté de voir ». 
visuel|Empr. au b. lat. visualis  « de la vue, visuel », du lat.  visum , supin de  videre  « voir » . 
visitation|Empr. au lat. visitatio, -onis  « apparition, manifestation »; dans la lang. chrét. « visite  » déb.  iii <sup e</sup s.,  Tertullien ; « visite de Dieu, pour juger, punir »  iv <sup e</sup s.,  St Jérôme ; spéc. « visite des malades [acte de charité] » ; « visite, inspection » ; au bas Moy. Âge  Visitatio Beatae Virginis Mariae  désignant la fête liturg. . 
visigoth|Empr. au b. lat. Wisigothae, Wisigothi  , comp. de  Gothi  « Goths » et de  Visi  « Wisigoths », qui appartient à une famille i.-e. signifiant « bon, noble »; les Wisigoths sont les « Goths nobles ». Voir M.  Schönfeld ,  Wörterbuch der altgermanischen Personen- und Völkernamen , pp. 267-268. 
vital|Empr. au lat. vitalis  «  id.  », dér. de  vita  « vie »;  cf.  l'a. fr.  vial  « vital, de la vie »  ca  1200 . 
vitupérant|Empr. au lat. vituperare « reprendre, critiquer, blâmer ». 
vitupération|Empr. au lat. vituperatio, -onis  « blâme, reproche ».
vitex|Empr. par les botanistes au lat. vitex  « gattilier », parce que les rameaux de cette plante sont aussi ployants que l'osier.  Cf.  la forme pop.  veze  « osier » conservée en occit. , m. fr.  vege  .
vitalité|Empr. au lat. vitalitas, -atis  «  id.  », dér. de  vitalis , v.  vital . 
vitupère|Empr. au lat. vituperare « reprendre, critiquer, blâmer ». 
vitamine|Empr. au terme vitamine  proposé en angl. par le biochimiste amér. d'orig. polon. C.  Funk  en 1912 , formé du lat.  vita  « vie » et de  amine , C. Funk croyant pouvoir classer ce type de substance parmi les  amines *. Le terme angl. fut ensuite corr. en  vitamin  pour qu'il soit plus conforme à la nomencl. chim. dans cette lang. . 
vitupérer|Empr. au lat. vituperare « reprendre, critiquer, blâmer ». 
vitriol|Empr. au lat. médiév. vitriolum , dér. de  vitrum  « verre », à cause de l'apparence vitreuse de ces sels. 
vivace|Empr. au lat. vivax, -acis , « qui vit longtemps ; animé, vif, bouillant ». 
vivacité|Empr. au lat. vivacitas, -atis  « force de vie, longue vie; durée »; à basse époque « vitalité de l'âme » , « vivacité de l'esprit, de la pensée » , « activité énergique  » . 
vitchoura|Empr. au polon. wilczura  « fourrure de loup ». 
vitre|Empr. au lat. vitrum  « verre  ». 
vitré|Empr. au lat. vitreus  « de verre, clair ou transparent comme du verre ». 
vocation|Empr. au lat. vocatio, -onis  « action d'appeler », « invitation » d'où en b. lat. eccl. « appel fait par Dieu »  vi <sup e</sup s. ds  Blaise Lat. chrét. , « invitation de Dieu à la foi »  i <sup er</sup s.,  ibid. , « appel à tel genre de vie, état »  iv <sup e</sup s.,  ibid.  formé sur le supin  vocatum  de  vocare  « appeler », dér. de  vox, vocis  « voix ». 
viverridés|Empr. au lat. sc. viverridae dér. de  viverra  « le furet » , lat. class.  viverra  de même sens .
vizir|Empr. au turc vezir  « vizir, ministre », et celui-ci à l'ar.  wazīr , mêmes sens. 
vocero|Empr. au corse voceru  « chant funèbre », dér. de  voce  .
vocable|Empr. au lat. vocabulum, -i  « mot », dér. de  vocare  « appeler », de  vox, vocis  « voix ». 
vivificateur|Empr. au lat. chrét. vivificator  « celui qui vivifie », empl. en partic. à propos du Saint Esprit . 
vocabulaire|Empr. au lat. médiév. vocabularium, -ii xiv <sup e</sup s. , dér. du class.  vocabulum , v.  vocable . 
vocifération|Empr. au lat. vociferatio, -onis  «  id.  », formé sur le supin  vociferatum  de  vocifere , v.  vociférer . 
vivification|Empr. au lat. chrét. vivificatio  « action de ressusciter; régénération; action de vivifier » . 
vivifier|Empr. au b. lat. vivificare  terme empl. par les aut. chrét. au sens propre « donner la vie » et au sens théol. « donner la vie de l'âme; ressusciter » . 
vociférer|Empr. au lat. vociferare  «  id.  », comp. de  vox, vocis  « voix » et  fere  « porter ». 
vivipare|Empr. au lat. viviparus  de mêmesens . 
vocatif|Empr. au lat. gramm. vocativus  «  id.  », formé sur le supin  vocatum  de  vocare  « appeler », dér. de  vox, vocis  « voix ».
volcan|Empr. à l'esp. volc n , att. au sens 1 à propos de l'Amérique , dep. le  xiii <sup e</sup s. à propos de la Sicile  et issu, par l'intermédiaire de l'ar.  burkān  , du lat.  Vulcanus , nom du dieu romain du feu et nom d'une des Îles Lipari , archipel volcanique au large de la Sicile. Le passage par l'ar. explique l'absence de  -o  final de la forme esp.;  Cor. - Pasc.  veut expliquer celle-ci par un empr. de l'esp. au port. mais le mot est beaucoup moins anc. en port. qu'en esp. et l'explication phonét. n'est pas satisfaisante . Le m. fr.  vulcan , att. une seule fois au  xiv <sup e</sup s. , se rapporte à la Sicile et est issu directement du lat. Voir P.  Aebischer  ds  Z. rom. Philol.  t. 67, pp. 298-318; R.  Arveiller  ds  Fr. mod.  t. 18, pp. 245-246; M.  Piron  ds  Romanica Gandensia  t. 4, pp. 193-208;  FEW  t. 14, pp. 639-640. 
volcanologie|Empr. à l'angl. vulcanology  ,  volcanology  , dér., à l'aide du suff.  -logy  , de  vulcan, volcan  « volcan ».
volcanologique|Empr. à l'angl. vulcanological  , dér. de  vulcanology  ; 2 représente une adapt. d'apr.  volcan * et ses dérivés.
volitif|Empr. au lat. médiév. volitivus  , dér. de  volitio  .  Cf.  l'ital.  volitivo et l'angl.  volitive  « relatif à la volition » , subst. ling. , adj. ling. .
volition|Empr. au lat. médiév. volitio , même sens , dér. sav. du rad.  vol-  de  voluntas ou  volo , 1<sup re</sup pers. du sing. de l'ind. prés. de  velle  « vouloir ». 
volatil|Empr. au lat. class. volatilis  « qui vole, ailé », au fig. « rapide, éphémère », dér. de  volare , v.  voler . 
volatile|Empr. au lat. class. volatilis  « qui vole, ailé », au fig. « rapide, éphémère », dér. de  volare , v.  voler . 
volkaméria|Empr. au lat. sc. Volckameria  , formé sur le nom du botaniste all. J. G. Volckamer [1616-1693]. 
volkameria|Empr. au lat. sc. Volckameria  , formé sur le nom du botaniste all. J. G. Volckamer [1616-1693]. 
volkamérie|Empr. au lat. sc. Volckameria  , formé sur le nom du botaniste all. J. G. Volckamer [1616-1693]. 
volley|Empr. à l'angl. volley-ball  , comp. de  ball  « ballon » et de  volley  issu du fr.  volée *, nom donné à ce jeu par son créateur, le maître de culture physique amér. W. G. Morgan en 1895 qui en publia les règles en 1897 . 
volume|Empr. au lat. volumen  « chose enroulée », « rouleau d'un manuscrit », « livre, ouvrage », « partie d'un ouvrage, tome ». 
volva|Empr. au lat. volva ou  vulva  « enveloppe  ».  Cf.  1783  volva  n. m. .
volontaire|Empr. au lat. voluntarius  «  qui agit librement, volontairement », spéc.  auxiliaria voluntaria  « contingents volontaires »;  voluntarii  subst. plur. « soldats volontaires » ; «  fait volontairement ». 
volte|Empr. à l'ital. volta  « action de tourner ou de se tourner » , déverbal de  voltare  . 
volvaire|Empr. au lat. sc. mod. volvaria , mêmes sens, dér. du lat.  volva  « enveloppe » .  Cf.  pour le sens 2 b lat. sc.  volvaria  att. ds  De Vries ,  Epicrisis , 1836-38 d'apr.  Léveillé  .
volter|Empr. à l'ital. voltare  « changer de direction » , « se tourner ou tourner une partie du corps » , issu d'un lat. vulg. * voltare , itér. du class.  volvere  « tourner ». 
volve|Empr. au lat. volva ou  vulva  « enveloppe  ».  Cf.  1783  volva  n. m. .
volvoce|Empr. au lat. sc. volvox globator  « chenille enrouleuse » .
voltiger|Empr. à l'ital. volteggiare , att. au sens A dep. av. 1470 , au sens de « voleter » dep. av. 1484  et comme terme d'équit. et d'escr. dep. le  xvi <sup e</sup s. , dér. de  voltare  . 
volubile|Empr. au lat. volubilis  « qui tourne aisément » d'où « rapide  ». 
volupté|Empr. au lat. voluptas, -atis  « plaisir, volupté » . 
vomique|Empr. au lat. médiév. vomica nux , formé du lat. class.  nux  « noix » et de  vomicus  « qui fait vomir », cette baie ayant des propriétés vomitives;  cf.  1555  la noix vomitique, ou vomitoire  . 
voluptuaire|Empr. au lat. voluptarius  « qui cause du plaisir » ; « concernant le plaisir; voluptueux », b. lat.  voluptuarius  «  id.  » .
volubilité|Empr. au lat. volubilitas  « mouvement giratoire, rotation », « rapidité, facilité de parole », « inconstance de la fortune », de  volubilis  . 
voluptueux|Empr. au lat. voluptuosus  « agréable, qui charme, qui plaît ». 
volucelle|Empr. au lat. sc. des zoologistes volucella  «  id.  », , dér. sav. du lat.  volucer  « ailé, volant, léger », avec suff. diminutif.
volute|Empr. à l'ital. voluta , att. comme terme d'archit. dep. av. 1452 , lui-même empr. au lat.  voluta , terme d'archit. , part. passé fém. subst. de  volvere  « rouler, enrouler ». 
volucre|Empr. au lat. volucris  « oiseau », empl. subst. de l'adj.  volucer, -cris  « qui vole, ailé », de  volare , v.  voler .
voter|Empr. à l'angl. to vote  d'abord « vouer, jurer »  puis intrans. au sens A 1  et trans. au sens B 1 , v.  NED , soit formé sur le rad. du supin du lat.  vovere  « faire un vœu, promettre par un vœu, vouer », rad. de  votum  , soit empr. au lat. médiév. de même formation  votare  « vouer, consacrer à un saint »  et « faire vœu, s'engager »  corresp. au fr.  voter  d'usage eccl. . 
votif|Empr. au lat. votivus  « promis par vœu » , spéc., dans la lang. chrét. « fait en vertu d'un vœu, à une intention particulière, consacré » .  Fête votive , en usage dans le Midi, est à rapprocher de l'occit.  voto  « fête patronale » , se rattachant au lat.  votum , v.  vœu . 
vomitoire|Empr. au lat. vomitorium , empl. le plus souvent au plur.  vomitoria  « portes de l'amphithéâtre conduisant aux gradins et offrant un dégagement à la foule ».  Cf.  l'adj.  vomitoire  « qui provoque le vomissement » , empr. au lat.  vomitorius , de même sens, dér. de  vomitum , supin de  vomire  . 
vorace|Empr. au lat. vorax  « insatiable, avide » , de  vorare  « dévorer, engloutir ». 
voracité|Empr. au lat. voracitas  « appétit insatiable ». 
vorticelle|Empr. au lat. sc. vorticella  , dér. du lat.  vortex, -icis p. allus. aux tourbillons produits par la couronne de cils de cette infusoire.
vote|Empr. à l'angl. vote , du lat.  votum  , att. dep.  ca  1460 au sens de « suffrage, expression selon une forme déterminée d'une position ou d'une décision sur une question mise au débat » d'où « décision, position prise par une assemblée ou un groupe de personnes s'exprimant par le suffrage » , ces empl. correspondent à ceux de  votum  en lat. médiév. chez les ecclésiastiques . 
vulturin|Empr. au lat. d'époque impériale vulturinus  « de vautour », dér. de  vultur , v.  vautour .
vulvaire|Empr. au lat. sc. vulvaria , dér. du lat. class.  vulva , v.  vulve , cette plante ayant été empl. en gynécologie.
vulve|Empr. au lat. class. vulva  « vulve, matrice »; 2 p. anal. de forme. 
vrac|Empr. au néerl. wrac  «  de rebut, endommagées ». 
vulgarité|Empr. au lat. tardif vulgaritas  « qualité de ce qui est commun », « la généralité , le commun », dér. de  vulgaris  . Les sens mod. 2 et 3 sont prob. dér. de  vulgaire *. 
vulgate|Empr. au lat. chrét. vulgata  , en parlant de la trad. cour. des Septante ou de sa trad. lat., chez  St Augustin  et  St Jérôme ; le sens mod., à partir du Concile de Trente .  Vulgata , fém. de  vulgatus , part. passé adj. de  vulgare  « répandre dans le public », « rendre accessible », dér. de  vulgus  « le commun des hommes, la foule ». 
vulgivague|Empr. au lat. vulgivagus « qui erre partout, vagabond » adj. donné à Vénus . 
vulnérable|Empr. au lat. tardif vulnerabilis  « qui peut être blessé », « qui blesse », dér. de  vulnerare  , avec peut-être l'infl. de l'angl.  vulnerable  « qui peut être blessé » , empr. lui aussi au latin. 
vulnéraire|Empr. au lat. vulnerarius  « relatif aux blessures », dér. de  vulnerare  « blesser ». 
vulcanisation|Empr. à l'angl. vulcanization , terme empl. par Th. Hancock [1786-1865] dans le brevet déposé en 1846 à la suite du procédé découvert par Ch. Goodyear [1800-1860] en 1839  et dér. de  to vulcanize  . 
vulnérant|Empr. au lat. vulnerare  « blesser » , dér. de  vulnus  « blessure, plaie », au fig. « atteinte ».
vulnérer|Empr. au lat. vulnerare  « blesser » , dér. de  vulnus  « blessure, plaie », au fig. « atteinte ».
vulpin|Empr. au lat. d'époque impériale vulpinus  « de renard », dér. de  vulpes  « renard ». B cette plante est appelée communément  queue-de-renard . 
vulgaire|Empr. au lat. vulgaris  « qui concerne la foule »; « général, ordinaire, commun, banal », dér. de  vulgus  « le commun des hommes, la foule ». On rencontre en a. et m. fr. la forme  vulgal , due à une forme lat. * vulgalis  issue de  vulgaris  par changement de suff. 
vultueux|Empr. au lat. class. vultuosus  « trop plein de jeux de physionomie, affecté » dér. de  vultus  « expression, air du visage, visage; jeux de physionomie ».
