rabbi|Empr. à l'hébr. postbiblique rabbι ̄ « maître, professeur » , formé de  rav  « chef, prince; seigneur, maître, professeur » et de  -ι ̄ , suff. pronom. de la 1<sup re</sup pers. du sing. Ce titre d'honneur et de respect était donné chez les Juifs, vraisemblablement dep. le 1<sup er</sup s. av. J.-C., aux docteurs de la Loi, puis à tout personnage ayant une autorité religieuse comme p. ex. dans le N.T. Jean-Baptiste  et Jésus-Christ . V.  Bible  1912. 
rabab|Empr. à l'ar. rabāb  « instrument de musique ressemblant au violon, à une, deux ou trois cordes ». 
raban|Empr. au néerl. raband , comp. de  ra  « vergue » et de  band  « lien ». 
rabouin|Empr. au fourbesque rabuino  « diable »  qui, comme l'ital.  rabacchio  « lutin » et le fr.  rabas, rabat  «  id.  » , serait dér. du rad. onomat.  *rab-  ; v.  Prati, DEI  et  Hope , p. 449. Pour P.  Barbier et  FEW  t. 10, p. 72a et 73a, l'ital.  rabuino  aurait été d'abord un des sobriquets du Diable et serait dér. de l'a. prov.  raboi  « derrière »  qui lui-même serait dér. de  rapum  « rave » ; pour Barbier, le mot a. prov. a dû signifier également « queue », la racine de la rave ayant été comparée à une queue  et le Diable aurait reçu en ital. ce surnom parce que la queue est l'un de ses traits les plus caractéristiques; pour  FEW ,  loc. cit.  et p. 71a et 74, notes 23 et 42, le surnom ital. du Diable aurait signifié « gros derrière »; pour L.  Lazzenini le sème commun à  derrière/sexe  et  diable  serait celui de  noir. Rabouin  figure également ds le  FEW  comme mot d'orig. inc. .
rabouine|Empr. au fourbesque rabuino  « diable »  qui, comme l'ital.  rabacchio  « lutin » et le fr.  rabas, rabat  «  id.  » , serait dér. du rad. onomat.  *rab-  ; v.  Prati, DEI  et  Hope , p. 449. Pour P.  Barbier et  FEW  t. 10, p. 72a et 73a, l'ital.  rabuino  aurait été d'abord un des sobriquets du Diable et serait dér. de l'a. prov.  raboi  « derrière »  qui lui-même serait dér. de  rapum  « rave » ; pour Barbier, le mot a. prov. a dû signifier également « queue », la racine de la rave ayant été comparée à une queue  et le Diable aurait reçu en ital. ce surnom parce que la queue est l'un de ses traits les plus caractéristiques; pour  FEW ,  loc. cit.  et p. 71a et 74, notes 23 et 42, le surnom ital. du Diable aurait signifié « gros derrière »; pour L.  Lazzenini le sème commun à  derrière/sexe  et  diable  serait celui de  noir. Rabouin  figure également ds le  FEW  comme mot d'orig. inc. .
rachis|Empr. au gr. ρ ̔ α ́ χ ι ς « épine dorsale; nervure médiane d'une feuille ».
race|Empr. à l'ital. razza , att. dep.  ca  1300 sous la forme  razzo  , puis  razza  « famille, espèce d'animaux » , d'orig. controversée. Pour  FEW  , qui reprend une hyp. déjà proposée par  Canello , L.  Spitzer et  Prati ,  razzo est issu du nomin. lat.  ratio  « calcul, compte; système, procédé » et en lat. chrét. « idée, conception  » , d'où « modèle d'une chose, d'un être vivant; race »; cette hyp. est confirmée par le fait que l'ital.  ragione , issu de l'acc.  rationem , a eu le sens de « qualité, espèce, race » du  xiii <sup e</sup au  xvii <sup e</sup s. . Pour G.  Merk  , qui reprend en la complétant une hyp. déjà formulée par C.  Salvioni et  REW <sup 3</sup n <sup o</sup 3732, l'ital.  razza  est issu avec aphérèse  du lat.  generatio  « génération, reproduction »,  naraccia  « race », att. au  xvi <sup e</sup s. dans le dial. de Belluno en Vénétie, pouvant représenter une forme intermédiaire ; à l'appui de cette hyp., G. Merk montre que les sens de l'a. ital. et de l'a. prov.  rassa  correspondent beaucoup plus à ceux du lat. biblique  generatio  « famille, descendance; engeance; espèce, race » qu'à ceux de  ratio  dont le sens le plus proche n'est que « caractéristique de ce qui appartient à la famille » ; il cite également l'a. fr.  generace  qui, issu de l'acc.  generationem , a eu le sens de « famille, race »  et de « bande de gens au service de quelqu'un » , ce 2<sup e</sup sens étant à rapprocher de l'a. prov.  rassa  « bande d'individus qui complotent »  qui s'explique mal à partir de l'étymon.  ratio . Pour G. Merk, l'ital.  razza , l'a. prov.  rassa  et l'a. fr.  generace  seraient en fait issus d'une contamination sém. et phonét. de  generatio avec  ratio , aidée par la synon. partielle de  natio  ; il s'agirait de mots pop.  et la forme ne viendrait pas du nomin. lat. mais d'une substitution de  -atia  à  -ationem . Pour d'autres hyp. et leurs critiques, v.  FEW  t. 10, p. 115a. 
racer|Empr. à l'angl. racer  « coureur » . 
rac|Empr. au viêtnamien rḁch  « canal, fossé rempli d'eau, marigot, arroyo ».
raca|Empr. au lat. raca et celui-ci au gr. ρ ̔ α κ α ́, transcr. d'un mot araméen, prob.  rēqā qui signifie proprement « vide » et qu'il faudrait comprendre « tête vide, sans cervelle » . 
radar|Empr. à l'anglo-amér. radar formé de la syll. init. de  Radio  et des lettres init. de  Detection, And  et  Ranging  dans l'expr.  Radio detection and ranging  « détection et pointage radio ». 
radical|Empr. au lat. tardif radicalis  « qui tient à la racine, premier, fondamental »  dér. de  radix, -icis  « racine, origine première ». C empr. à l'angl.  radical , de même orig., qui à partir du sens de « absolu, complet »  a désigné les partisans de réformes extrêmes . 
rade|Empr. au m. angl. rade  att. au même sens dep. 1320, issu du vieil angl.  rád  « chevauchée, voyage, passage » qui est aussi à l'orig. de la forme mod.  road  « voie, chemin, route », v. aussi  raid .
radicale|Empr. au lat. tardif radicalis  « qui tient à la racine, premier, fondamental »  dér. de  radix, -icis  « racine, origine première ». C empr. à l'angl.  radical , de même orig., qui à partir du sens de « absolu, complet »  a désigné les partisans de réformes extrêmes . 
radeau|Empr. à l'a. prov. radel  «  id.  »  xiii <sup e</sup s. ds  Levy Prov. , dimin. de  rat  «  id.  » même ex.  ibid.  , du lat.  ratis  «  id.  »;  cf.  le lat. médiév.  radellus, razellus  «  id.  »  xiii <sup e</sup s. ds  Nierm. , et le m. fr.  radelles de fuz  chez  Bersuire  1355 . 
racket|Empr. à l'anglo-amér.  racket  , spécialisation de sens de l'angl.  racket  « tapage, tintamarre, désordre »  d'orig. obsc., et att. en arg. dep. 1812 pour désigner une activité, une ruse particulière dans le monde des malfaiteurs .
racler|Empr. au prov. rasclar  « passer la racloire sur une mesure de grains pour faire tomber ce qui s'élève au-dessus du bord »  et « enlever avec un instrument quelques parties de la surface d'un corps » , d'un lat. pop. * rasclare , issu par syncope de * rasǐcŭlare , du lat.  rasus  , part. passé de  radere  « raser ». 
radicant|Empr. au lat. radicans, -antis , part. prés. de  radicari  « prendre racine, pousser des racines », dér. de  radix, radicis  « racine ». Déjà  radicant leaf , en 1753, en angl. .
radian|Empr. à l'angl. radian  att. en trigonométrie dep. 1879 ds  NED , du lat.  radius  « rayon », suff.  -an,  corresp. au fr.  -an *.
radiant|Empr. au part. prés. lat. radians, -antis  « rayonnant; brillant » de  radiare  « rayonner; étinceler » et trans. « munir de rayons; irradier »; dér. de  radius,  v.  radiaire.  L'angl.  radiant point  « point d'où émanent des rayons » est att. dep. 1726 ds  NED. 
radicule|Empr. au lat. radicula  « petite racine », dimin. de  radix, radicis  « racine ». 
radié|Empr. au lat. radiatus  « rayonnant, muni de rayons lumineux », « formé de rayons », dér. de  radius , v.  radiaire ; le verbe  radiare  « rayonner » semblant postérieur . L'angl.  radiate  est att. dep. 1668 ds  NED: Radiate flower. 
radiée|Empr. au lat. radiatus  « rayonnant, muni de rayons lumineux », « formé de rayons », dér. de  radius , v.  radiaire ; le verbe  radiare  « rayonner » semblant postérieur . L'angl.  radiate  est att. dep. 1668 ds  NED: Radiate flower. 
radiées|Empr. au lat. radiatus  « rayonnant, muni de rayons lumineux », « formé de rayons », dér. de  radius , v.  radiaire ; le verbe  radiare  « rayonner » semblant postérieur . L'angl.  radiate  est att. dep. 1668 ds  NED: Radiate flower. 
radieux|Empr. au lat. radiosus  « rayonnant », dér. de  radius  « rayon lumineux » . 
radis|Empr. à l'ital. radice  « radis » , propr. « racine », du lat.  radix, -icis  «  id.  ». Le sens 2 est dû à l'infl. de  rond  « sou »  et des noms de petits fruits et légumes désignant des choses de peu de valeur ; le sens 3 à l'anal. de forme. Voir  FEW  t. 10, pp. 27-28b et  Cellard - Rey . 
radius|Empr. au lat. radius  terme d'anat., p. ext. de sens de « baguette; rayon ». 
radome|Empr. à l'angl. radome formé de la 1<sup re</sup syll. de  radar * et de  dome  issu du fr.  dôme <sup 2</sup *.
radôme|Empr. à l'angl. radome formé de la 1<sup re</sup syll. de  radar * et de  dome  issu du fr.  dôme <sup 2</sup *.
rafflesia|Empr. au lat. sav. rafflesia formé sur le n. de Sir T. Stamford Raffles , gouverneur britannique de Sumatra qui découvrit cette plante.
ragtime|Empr. à l'anglo-amér. rag-time ,  ragtime comp. de l'anglo-amér.  rag  désignant un type de danse  et de l'angl.  time  « temps » plus spéc. « mesure, tempo ». 
raguer|Empr. à l'angl. to rag  « déchirer, mettre en lambeaux » , de  rag  « lambeau, chiffon », prob. issu du vieil angl.; l'hyp. d'un empr. au néerl.  ragen  « brosser, nettoyer en enlevant la toile d'araignée »  est sémantiquement moins acceptable .
raïa|Empr. au turc râya  « sujet non musulman de l'Empire ottoman », lui-même empr. à l'ar.  ra <sup  207 </sup  āya,  plur. de  ra <sup  207 </sup  ι ̄ya  « troupeau; sujets, peuple », dér. du verbe  ra <sup  207 </sup  ā « faire paître » .
raid|Empr. à l'angl. raid  « expédition militaire à cheval »  d'où « incursion, charge » , empr. à la forme écossaise du vieil angl.  rád  d'où est issu l'angl.  road  « chevauchée, voyage à cheval » puis « route ». 
raillière|Empr. au gasc. ralhère, arralhère  « éboulis, ravin profond plein d'éboulis »  que  Mistral  assimile au prov.  raiero  « petite gorge de montagne, ravin, ruisseau » classé par  FEW  t. 10, p. 23a, avec l'a. fr.  rahiere  « conduit qui amène l'eau sur la roue d'un moulin » , parmi les termes issus du lat.  radius  .
railway|Empr. à l'angl. rail-way ,  railway comp. de  rail et de  way  « voie », concurrent de  railroad  plus usité aux États-Unis , railway  entrant dans le nom de la première compagnie nationale anglaise de chemins de fer . 
rak|Empr. à l'angl. rack  « râtelier; casier, étagère, support » , « châssis métallique supportant les pièces d'une installation téléphonique ou électronique » .
raki|Empr. au turc rakι , même sens, lui-même empr. à l'ar.  araqι ̄ , dér. de  araq , empl. pour  araq at-tamr , propr. « sueur  de dattier  », c'est-à-dire « suc extrait du dattier, qui, par fermentation, acquiert des qualités alcooliques », et, p. ext. « eau-de-vie, toute liqueur distillée » ,  cf. arack  et  rack <sup 1</sup . 
rail|Empr. à l'angl. rail  « barre de bois horizontale »  d'où spéc. « barre ou ligne continuelle de barres  servant de support et de guide aux roues des voitures »  puis « chemin de fer, transport par chemin de fer »  v.  NED  et  NED Suppl. <sup 2</sup ; le m. angl.  rail  est issu de l'a. fr.  reille  « barre de porte, barre, barrière », du lat.  regula  « règle, barre » . 
rajah|Empr. à l'hindi rājā « roi », du skr.  rājan-  « roi », de même orig. que le lat.  rex  .  Cf.  aussi  maharajah  et  rani . 
raïs|Empr. à l'ar. ra' ι ̄s  « chef, président, directeur », dér. de  ra's  « tête ».  Cf. reis <sup 1</sup . 
raillère|Empr. au gasc. ralhère, arralhère  « éboulis, ravin profond plein d'éboulis »  que  Mistral  assimile au prov.  raiero  « petite gorge de montagne, ravin, ruisseau » classé par  FEW  t. 10, p. 23a, avec l'a. fr.  rahiere  « conduit qui amène l'eau sur la roue d'un moulin » , parmi les termes issus du lat.  radius  .
ralingue|Empr. à l'a. nord. *rár-lík , comp. de  rar , génitif de  rá  « vergue » et de  lík  « bord d'une voile »;  cf.  d'autres comp. de  rá  en a. nord.:  rár-endi, rár-hlutr  . 
ramequin|Empr. au néerl. rammeken , att. au sens 1 . 
rance|Empr. au lat. rancidus  « qui sent, putréfié, infect, désagréable ». Le mot est att. en a. prov. sous la forme  ransa au sens de « flétri, fané  » du  xii <sup e</sup s. au  xiii <sup e</sup s. .
ranch|Empr. à l'anglo-amér. ranch lui-même empr. à l'hispano-amér.  rancho  « maison de berger ou d'ouvrier agricole », de l'esp.  rancho  « campement, lieu de réunion de soldats ou d'autres personnes rassemblées pour manger », du verbe de la lang. des soldats  rancharse  ou  ranchear  « s'installer, se loger » empr. au fr.  ranger* . 
ramifier|Empr. au lat. médiév. ramificare  « se diviser en rameaux » , formé de  ramus  « rameau, branche » et  facere  « faire », francisé d'apr. les verbes en  -fier . 
rancho|Empr. à l'esp. et à l'hispano-amér. rancho , v.  ranch*  étymol.
rams|Empr. à l'all. Rams , de même sens, lui-même empr. au fr.  ramas*  .
ramuscule|Empr. au b. lat. ramusculus  « petite branche » . 
rani|Empr. à l'hindi rānι ̄ , du skr.  rājñι ̄ « reine », fém. de  rājan  « roi » . Le corresp. angl.  ranee  est att. en 1858 , et déjà en 1698 et 1781 sous les formes  Ranna  et  Rhanny . 
rapatrier|Empr. au lat. médiév. repatriare « rentrer dans sa patrie » , avec changement du suff.  re-  en  ra- . 
raphé|Empr. au gr. ρ ̔ α φ η ́ « couture »; « suture du crâne ».
raphia|Empr. au malg. raphia  ;  rafia  ;  rofia  ;  raofìa ,  rofia  . À signaler également la forme  rofeer  dans le récit d'un voyageur anglais: 1729,  Drury ,  Madagascar  , 172 ds  NED, s.v. rofia : Where the cattle are kept is a tree called  rofeer . 
ranule|Empr. au lat. ranula  « petite grenouille » et en b. lat. « tumeur » , dimin. de  rana  « grenouille ».
rapine|Empr. au lat. rapina  « vol, pillage, action d'emporter », de  rapere  « emporter, entraîner, ravir ». 
raout|Empr. à l'angl. rout  « compagnie, bande, rassemblement »  d'où « réunion mondaine, réception » aux  xviii <sup e</sup et  xix <sup e</sup s. , lui-même empr. à l'a. fr.  rote, route  « troupe en marche »  de même orig., à partir d'un sémantisme partic., que le fr. mod.  route * . 
rapace|Empr. au lat. rapax, rapacis  « qui entraîne à soi, ravisseur, pillard, voleur », de  rapere  « emporter précipitamment ». On rencontre ant. la forme  rapiaus  , placé en rime avec  maus , plur. d'une forme  rapal , empr. au lat.  rapax  avec changement de suff. . 
rapide|Empr. au lat. rapidus, -a, -um  « qui entraîne, emporte, impétueux, prompt », qui s'est substitué à l'a. et m. fr.  rade »  Chrétien de Troyes, Erec , éd. M. Roques, 5125). 
rapacité|Empr. au lat. rapacitas  « penchant au vol », dér. de  rapax , v.  rapace . 
rapidité|Empr. au lat. rapiditas  « impétuosité, rapidité  », a supplanté l'a. et m. fr.  radece ,  radesse  . 
rapatrié|Empr. au lat. médiév. repatriare « rentrer dans sa patrie » , avec changement du suff.  re-  en  ra- . 
rarissime|Empr. à l'ital. rarissimo  « très rare » , superl. de  raro  « rare » . 
rapt|Empr. au lat. raptus  « enlèvement, rapt », dér. du verbe  rapere  « emporter, entraîner violemment; enlever, ravir » . Au sens 2, v.  pick-up . 
rascasse|Empr. à l'a. prov. rascassa  « sorte de poisson » , fém. subst. de l'adj. prov.  rascas  « atteint de la teigne, teigneux » , lui-même dér. de  rasca  « teigne »  remontant au b. lat.  *rasicare  « gratter, râcler », v.  rache <sup 2</sup , ce poisson étant ainsi dénommé en raison des nombreuses taches qu'il porte et qui évoquent la teigne. Selon P.  Barbier rascasse  est empr. au prov.  rascassa  «  id.  » par l'intermédiaire de l'adj.  rascas  pris au sens de « brut, piquant, rude » mais ce sens  ne semble pas att. en a. prov., mais seulement au  xviii <sup e</sup s.  et n'est pas relevé par  Mistral . 
raquette|Empr. à l'ar. rāḥa  « paume » par l'intermédiaire du lat. médiév. des textes méd.:  rasceta manus  « le carpe » ,  rasca  « le tarse » ;  raseta  « le carpe » . Selon  Devic , les formes  rascette, rasquette  , issues de l'ar.  rāḥa , auraient subi l'infl. d'un autre mot ar.,  rusġ « carpe; tarse ». 
raréfaction|Empr. au lat. médiév. rarefactio  , dér. du lat.  rarefacere  . 
raréfier|Empr. au lat. rarefacere  « rendre moins dense » , avec adapt. au moyen du suff.  -fier  ,  cf. liquéfier, putréfier  et  Nyrop  t. 3, § 440. 
rash|Empr. à l'angl. rash  « éruption, exanthème »  prob. empr. à l'a. ou m. fr.  raiche, rache, rasche  « teigne » . 
rarescent|Empr. au lat. rarescens , part. prés. de  rarescere  « devenir moins dense, moins épais », dér. de  rarus  .
rareté|Empr. au lat. raritas  « porosité, faible texture; cavité, interstice; éparpillement; rareté, faible nombre; caractère exceptionnel; objet rare » , d'où  rarité , puis  rareté  d'apr.  rare *. 
ratiocinant|Empr. au lat. ratiocinari  « calculer », dér. de  ratio-, -onis  « compte », v.  raison . 
ratiocinateur|Empr. au lat. ratiocinator, -oris  « calculateur », formé sur  ratiocinor , v.  ratiociner ;  cf.  le subst.  ratiocinateur  « esclave ou affranchi qui tenait les comptes du maître » dep. 1842,  Ac. Compl. 
ratanhia|Empr. au quichua  prob. par l'intermédiaire de l'angl. ;  cf.  ital.  ratania  , esp.  ratania  , port.  ratanha, ratânhia  .
ratiocination|Empr. au lat. ratiocinatio , - onis  «  id.  », formé sur  ratiocinari , v.  ratiociner. 
ratepenade|Empr. à l'a. prov. ratapennada  «  id.  » , comp. de  rata  « souris »  et de  pennada,  fém. de  penat  « qui a des ailes », dér. de  pena  « aile, plume » .
ratiocinatrice|Empr. au lat. ratiocinator, -oris  « calculateur », formé sur  ratiocinor , v.  ratiociner ;  cf.  le subst.  ratiocinateur  « esclave ou affranchi qui tenait les comptes du maître » dep. 1842,  Ac. Compl. 
ratiociner|Empr. au lat. ratiocinari  « calculer », dér. de  ratio-, -onis  « compte », v.  raison . 
rational|Empr. au b. lat. eccl. rationale  , de même sens, neutre subst. de l'adj. lat.  rationalis  « raisonnable » , ce morceau d'étoffe ayant été ainsi nommé à cause des sages devises qu'il portait. Le nom de cet ornement sacerdotal est souvent rendu dans les traductions de la Bible par le mot  raisonnable  . Au  xvi <sup e</sup s.  rational  est remplacé par  pectoral *.
ratification|Empr. au lat. médiév. ratificatio, -onis  «  id.  » 1228 ds  Latham , formé sur le supin  ratificatum  de  ratificare  « ratifier »;  cf.  l'a. m. fr.  ratifiement  « confirmation » 1299  − 1630 . 
ratifier|Empr. au lat. médiév. ratificare  «  id.  »  ca  1224 ds  Latham , sur le modèle des mots en  -fier , dér. du neutre  ratum  de l'adj.  ratus  « qui compte » d'où « valable, approuvé » de  reri  « compter »;  cf.  le m. fr.  ratifiquer  « approuver, confirmer » 1513 . 
rastaquouère|Empr. à l'hispano-amér. rastracueros  « personne méprisable » , « tanneur, grossiste en peaux, en cuirs » , comp. de  arrastrar  « ratisser »  et de  cueros  « cuirs, peaux ». Le sens péj. du fr. est prob. dû au fait que beaucoup de Sud-américains à l'élégance tapageuse qui séjournaient à Paris à la fin du  xix <sup e</sup s. devaient leur fortune récente au commerce des cuirs et peaux . Le mot a été réempr. au fr. avec ce nouveau sens par l'hispano-amér. d'Argentine et du Chili . 
rationnel|Empr. au lat. rationalis  « doué de raison, où l'on emploie le raisonnement, fondé sur le raisonnement », dér. de  ratio  « raison ». 
rating|Empr. à l'angl. rating , subst. verbal de  to rate  « fixer le montant de, évaluer, estimer », att. dep. 1702 dans le domaine de la nav. d'abord pour désigner le classement de pers. et dep. 1891 en parlant de bateaux . 
ratites|Empr. au lat. sc.  ratitae  « au sternum en radeau, sans bréchet » , p. oppos. aux carinatae  « au sternum caréné, avec bréchet » dans la classification de Merrem .
raucité|Empr. au lat. raucitas  « enrouement, raucité, son rauque ».
rauque|Empr. au lat. raucus  « enroué, au cri rauque »,  cf.  aussi l'a. fr.  raus  « enroué » . 
ravelin|Empr. à l'ital. rivellino , terme de fortif. att. dep. le  xv <sup e</sup s. , var.  ravellino  , dér. dimin. de  riva  . Voir  FEW  t. 10, pp. 413b-414a, et  Hope , p. 49. 
rayonne|Empr. à l'anglo-amér. rayon apparenté au fr.  rayon <sup 1</sup *, soit par réutilisation de cette forme qui avait déjà été empr. au fr., soit par réemprunt direct, soit par formation sur l'angl.  ray  « rayon » issu du fr.  rai* . 
raz|Empr. à l'a. nord. rás  « courant ; course, chute » . Le bret.  raz  est empr. au fr. . 
razzia|Empr. à l'ar. maghrébin ġāziya « expédition militaire, campagne; incursion, attaque » . 
rebab|Empr. à l'ar. rabāb  « instrument de musique ressemblant au violon, à une, deux ou trois cordes ». 
rebelle|Empr. au lat. rebellis « qui se révolte, se soulève ». 
rebellé|Empr. au lat. rebellare « se révolter, se soulever ».  Rebeller  a évincé dans la période du m. fr., la forme pop.  reveler  « se révolter » . 
recette|Empr. au lat. recepta  part. passé fém. ou neutre plur. de  recipere  « recevoir », v. ce mot;  cf.  lat. médiév.  recepta, receptum et  receptus « somme d'argent reçue » . 
recenser|Empr. au lat. recensere  « passer en revue, énumérer » . 
recognition|Empr. au lat. recognitio  « revue, examen, inspection, reconnaissance ».
reconvention|Empr. au lat. médiév. reconventio , de même sens , dér. de  conventio  « accord, pacte » .
record|Empr. à l'angl. record  « enregistrement, document écrit  » , d'où « fait exceptionnel  digne d'être enregistré » , de l'a. fr.  recort, record  . 
rectangle|Empr. au lat. médiév. rectangulus  att. comme adj. en 1267 , du b. lat.  rectiangulus « à angles droits », subst.  rectiangulum  « triangle rectangle » att. chez Isodore. 
recteur|Empr. au lat. rector « celui qui dirige », « précepteur » et « gouverneur d'une province »; le sens 2 b est issu du sens de « supérieur ecclésiastique, prélat, directeur de certaines maisons religieuses » que le mot avait pris aux  iv <sup e</sup - v <sup e</sup s. ; v.  Nierm.  pour les attest. des différents sens en lat. médiéval.
rection|Empr. au lat. rectio  « action de gérer, administration, gouvernement ». 
rectifiant|Empr. au b. lat. rectificare  « redresser » . 
rectum|Empr. au lat. méd. rectum  « même sens », p. ell. de  rectum intestinum  « intestin droit » . 
rectitude|Empr. au b. lat. rectitudo  « direction en ligne droite », fig. « droiture, justice ». 
rectification|Empr. au b. lat. rectificatio  « redressement » . 
rectifier|Empr. au b. lat. rectificare  « redresser » . 
rectiligne|Empr. au b. lat. rectilineus  « en ligne droite, rectiligne ». 
reddition|Empr. au b. lat. redditio, -onis  « action de rendre » déb.  v <sup e</sup s. ds  Blaise Lat. chrét. , formé sur le supin  redditum  de  reddere  « rendre », dér. de  dare  « donner ». 
redondance|Empr. au lat. redundantia « trop plein, abondance, excès, redondance du style ». En ling. et télécomm. et plus gén. dans la théorie de l'inform., réempr. à l'anglo-amér. de même orig.  redundance  . 
redondant|Empr. au lat. redundans, -tis  « débordant, superflu » part. passé adj. de  redundare  . Att. en angl. au sens 3 dep. 1710  et au sens 4 dep. 1954 . 
redonder|Empr. au lat. redundare  « déborder » d'où « être surabondant, exubérant  », dér. de  unda  « eau, onde, flot ». 
redowa|Empr. à l'all. Redowa , de même sens, lui-même empr. au tch.  rejdovák  « sorte de danse rustique de Bohême », dér. de  rejditi , itératif  rejdovati  « s'ébattre, gambader », ce verbe étant à son tour dér. de  rej  « danse » .
refluant|Empr. au lat. refluere  « couler en sens inverse, se retirer »;  cf.  le m. fr.  refluir  , de même orig., avec changement de conjug. 
refluer|Empr. au lat. refluere  « couler en sens inverse, se retirer »;  cf.  le m. fr.  refluir  , de même orig., avec changement de conjug. 
reflex|Empr. à l'angl. reflex  «  id.  » adj. et subst. 1895 et 1926-27 ds  NED Suppl. <sup 2</sup , d'abord « réflexion ou image d'un objet, comme vue dans un miroir » 1638 ds  NED,  du fr.  reflet * d'apr. le lat.  reflexum,  supin de  reflectere,  v.  réfléchir. 
refréner|Empr. au lat. refrenare « dompter, maîtriser ».  Refréner  a évincé le synon. a. fr.  refraindre  , du lat. vulg.  refrangere , class.  refringere  « briser »,  cf. enfraindre* . 
reg|Empr. à l'ar. ruqq  « reg » .  Cf.  l'angl.  reg , att. dès 1904 .
regency|Empr. à l'angl. Regency  « régence » dans son empl. pour désigner la période de régence du prince de Galles, futur Georges IV, de 1810 à 1820, et en appos. pour qualifier la mode ou les objets caractéristiques de cette époque .
refuge|Empr. au lat. refugium  « action de se réfugier; refuge, asile » au propre et au fig.  Cf.  la forme pop. a. fr.  refui  . 
regeste|Empr. au lat. tardif regesta , v.  registre .
reggae|Empr. à l'angl. de la Jamaïque reggae  d'orig. obsc. .
registre|Empr. au lat. tardif regesta  « registre, catalogue » part. plur. neutre subst. de  regerere , empl. dans la lang. de la rhét. au sens de « reporter, transcrire ». La finale en  -istre  est due prob. à l'infl. de  épistre, épître* . Pour le sens techn. B 1,  cf.  le lat. médiév.  registra campanorum « corde de la cloche ». 
regrès|Empr. au lat. regressus  « retour, possibilité de revenir en arrière, recours », spéc. en lat. médiév. « possibilité de reprendre possession de ce que l'on a résigné ou transmis » .
reis|Empr. au turc reis  « chef, président; capitaine », lui-même empr. à l'ar.  ra'ι ̄s  . 
religiosité|Empr. au lat. religiositas  « sentiment religieux » ; « religion, piété » dans la lang. chrét. . 
relaps|Empr. au lat. médiév. relapsus  « retombé dans l'hérésie » , empl. partic. du part. passé du class.  relabi  « tomber en arrière ». 
relaxation|Empr. au lat. relaxatio  « relâchement, détente, repos », dér. de  relaxare  « desserrer, relâcher ». Aux sens 3 et 4, d'apr. l'angl.  relaxation , de même orig., att. dep. le  xvi <sup e</sup s., notamment au sens de « détente de l'esprit, repos » et en technol. dep. le  xix <sup e</sup s. . 
relapse|Empr. au lat. médiév. relapsus  « retombé dans l'hérésie » , empl. partic. du part. passé du class.  relabi  « tomber en arrière ». 
relique|Empr. au lat. reliquia , plur.  reliquiae  « reste », spéc. « survivants » ; « restes, cendres d'un mort » ; fig.:  reliquiae pristinae fortunae, belli . 
relaxer|Empr. au lat. relaxare  « desserrer, relâcher ». 
relatif|Empr. au b. lat. relativus « qui est en rapport avec » . 
relation|Empr. au lat. relatio  « action de rapporter un fait, un témoignage »  et « lien, rapport ». 
relégation|Empr. au lat. relegatio  « exil », dér. de  relegare  .
religieuse|Empr. au lat. religiosus  « scrupuleux », spéc. « d'une attention scrupuleuse à l'égard du culte divin; religieux, pieux; qui éprouve des scrupules religieux »; «  vénéré, respecté;  saint, consacré ». Dans la lang. chrét. « relatif à l'Église, ecclésiastique » 1<sup re</sup moit.  iii <sup e</sup s.,  St Cyprien ); « qui mène une vie dégagée du monde ou vit dans un monastère » ; empl. subst. « religieux, moine » , v.  Blaise, Lat. chrét. 
reléguer|Empr. au lat. relegare  « éloigner, bannir », dér. de  legare  « envoyer, déléguer ». 
religieux|Empr. au lat. religiosus  « scrupuleux », spéc. « d'une attention scrupuleuse à l'égard du culte divin; religieux, pieux; qui éprouve des scrupules religieux »; «  vénéré, respecté;  saint, consacré ». Dans la lang. chrét. « relatif à l'Église, ecclésiastique » 1<sup re</sup moit.  iii <sup e</sup s.,  St Cyprien ); « qui mène une vie dégagée du monde ou vit dans un monastère » ; empl. subst. « religieux, moine » , v.  Blaise, Lat. chrét. 
religion|Empr. au lat. religio  « attention scrupuleuse; conscience »; spéc. « scrupule religieux, sentiment religieux, crainte pieuse; vénération, pratique religieuse, culte; croyance religieuse, religion » et « caractère sacré; engagement sacré; chose sainte, objet sacré ». Dans la lang. chrét. « vie religieuse, monastère; profession religieuse » , « ordre religieux » , « ensemble des vérités et des devoirs religieux » . L'orig. du mot lat. est discutée . 
remédiable|Empr. au lat. remediabilis  « guérissable », dér. de  remediare  .
remédier|Empr. au lat. remediare  « guérir », dér. de  remedium  . 
remake|Empr. à l'anglo-amér. remake  , subst. du verbe  to remake  « refaire ». 
remémoration|Empr. au lat. chrét. rememoratio  « rappel, souvenir, commémoration » . 
remémorer|Empr. au lat. chrét. rememorari  « se ressouvenir » ou, trans.  rememorare  « rappeler »  parallèlement à l'a. fr.  remembrer  « rappeler, rappeler le souvenir de »  de même origine. 
remède|Empr. au lat. remedium  « remède, médicament »; fig. « préservatif, expédient », dér. de  mederi  « soigner, traiter ». L'a. fr. possède, parallèlement, la forme  remire  . 
remorquer|Empr. à l'ital. rimorchiare  « remorquer », att. dep. 1431 , issu d'un lat. vulg.  *remulculare,  forme élargie de  remulcare  , dér. de  remulcum  « câble de remorquage ». Le m. fr.  remocquer,  att. en 1449  et en 1495  est empr. à l'a. prov.  remocar  ;  remolquer,  att. de 1541  à 1660  est empr., peut-être par l'intermédiaire de l'esp., au cat.  remolcar,  att. dep. 1258 ; l'a. prov. et le cat. sont tous deux issus du lat.  remulcare.  V.  Vidos,  pp. 559-562, et  Hope,  p. 219. 
renne|Empr. au norv. ou suédois ren  «  id.  ». L'a. et m. fr. connaît aussi un subst.  rengier/rangier  «  id.  » , encore en usage comme terme d'hérald. et qui est empr. au dan.  rendyr  «  id.  » qui remonte à l'a. nord.  hreindȳri  . Voir  FEW  t. 16, p. 695a et  Kluge <sup 20</sup . 
renoncer|Empr. au lat. renuntiare  « annoncer en retour »; « renvoyer, renoncer à », comp. du préf.  re-  marquant le mouvement en retour et  nuntiare  « annoncer, faire savoir ». 
renonciation|Empr. au lat. renuntiatio  « déclaration, annonce », dans la lang. jur. tardive « renonciation ». 
renoncule|Empr. au lat. ranuncula , prop. « petite grenouille » . Ce nom vient de ce que la plupart des espèces de ce genre habitent les lieux marécageux . 
