sabellique|Empr. au lat. sabellicus  « des Sabelles, des Sabins », de  Sabelli  subst. masc. plur. « Sabelles  ».
sabin|Empr. au lat. Sabini , plur.  et  sabinus  « des Sabins ». 
sabine|Empr. au lat. Sabini , plur.  et  sabinus  « des Sabins ». 
saburre|Empr. au lat. saburra  « lest de navire », déjà empl. au fig. dans l'adj.  saburratus  « qui a l'estomac lesté ».
sabayon|Empr. à l'ital. du Nord zabaione  « crème faite de jaunes d'œufs battus avec du sucre et du Marsala » , peut-être à rapprocher, soit du lat. tardif  sabaia  « espèce de bière », mot dalmate , soit du ferrarais  zabajón  « mélange »,  zabui  «  id.  », trentin  zabai  « confusion, intrigue », mantouan  zaboi  « intrigue » . Voir  FEW  t. 21, p. 494a. 
sabbat|Empr. au lat. chrét. sabbatum , lui-même empr. au gr. σ α ́ β β α τ ο ν et celui-ci à l'hébr.  shābbath  « sabbat », dér. du verbe  shābath  « s'arrêter; se reposer » . Au sens 3,  cf.  le lat. médiév.  sabbatum  . On a également employé, pour désigner les assemblées de sorciers et de sorcières, le mot  synagogue  , en lat.  synagoga  . En ce qui concerne la dégradation sém. qu'ont subie les mots  sabbat  et  synagogue, cf. brouhaha ,  ramadan, ramdam. 
sabbatique|Empr. au lat. chrét. sabbaticus  « sabbatique »  et celui-ci au gr. σ α β β α τ ι κ ο ́ ς « qui concerne le sabbat, sabbatique », dér. de σ α ́ β β α τ ο ν . L'expr.  an sabbatique  est la trad. de l'hébr. biblique  sěnat šabbātōn  « année de repos, de cessation » . Au sens 1 b, trad. de l'angl. amér.  sabbatical year  ,  sabbatical leave  . 
sabre|Empr. à l'all. Sabel  , lui-même empr. au hongr.  száblya , peut-être par l'intermédiaire du polon.  szabla  ou du russe  sablja  . 
saccager|Empr. à l'ital. saccheggiare , att. dep. le  xiii <sup e</sup s. , dér. de  sacco  « saccage » . 
sacrificateur|Empr. au lat. chrét. sacrificator  «  id.  » ; le lat.  sacrificatrix  est att. dans des inscriptions comme épithète de Vénus. 
saccule|Empr. au lat. sacculus  « petit sac, bourse », dimin. de  saccus  .
sacculine|Empr. au lat. sc. sacculina , att. au sens 1 dep. 1816 , au sens 2 dep. 1829 , du lat.  sacculus  ; suff.  -ine  .
sacramental|Empr. au lat. chrét. sacramentalis  « mystique, symbolique » .
sacrificatrice|Empr. au lat. chrét. sacrificator  «  id.  » ; le lat.  sacrificatrix  est att. dans des inscriptions comme épithète de Vénus. 
sacerdoce|Empr. au lat. sacerdotium  « sacerdoce », « dignité d'augure ». 
sacramentale|Empr. au lat. chrét. sacramentalis  « mystique, symbolique » .
sacerdotal|Empr. au lat. sacerdotalis  « de prêtre, sacerdotal ». 
sacrifice|Empr. au lat. sacrificium  « offrande à la divinité » , et chez les aut. chrét. « le sacrifice eucharistique, la messe », « pain consacré, divines espèces » . 
sacramentel|Empr. au lat. sacramentalis , v.  sacramental . 
sacrifié|Empr. au lat. sacrificare littéral. « accomplir une cérémonie sacrée » d'où « offrir en sacrifice à une divinité ». 
sacrant|Empr. au lat. sacrare  « consacrer à une divinité; rendre sacré », de  sacer, sacrum  « sacré  »  cf. Ern. - Meillet : «  Sacer  désigne celui ou ce qui ne peut être touché sans être souillé, ou sans souiller »: de là le double sens de « sacré » ou « maudit ». L'empl. comme intensif blasphématoire de  sacré et l'ext. de sens de  sacrer  à « proférer des jurons »  peuvent être dus à l'attraction de  sacre  « brigand, homme sans foi ni loi » ,  cf. Gougenheim  ds  B. jeunes Rom. , n <sup o</sup 4, pp. 5-7. 
sacrifiée|Empr. au lat. sacrificare littéral. « accomplir une cérémonie sacrée » d'où « offrir en sacrifice à une divinité ». 
sacrifier|Empr. au lat. sacrificare littéral. « accomplir une cérémonie sacrée » d'où « offrir en sacrifice à une divinité ». 
sacré|Empr. au lat. sacrare  « consacrer à une divinité; rendre sacré », de  sacer, sacrum  « sacré  »  cf. Ern. - Meillet : «  Sacer  désigne celui ou ce qui ne peut être touché sans être souillé, ou sans souiller »: de là le double sens de « sacré » ou « maudit ». L'empl. comme intensif blasphématoire de  sacré et l'ext. de sens de  sacrer  à « proférer des jurons »  peuvent être dus à l'attraction de  sacre  « brigand, homme sans foi ni loi » ,  cf. Gougenheim  ds  B. jeunes Rom. , n <sup o</sup 4, pp. 5-7. 
sacrilège|Empr. au lat. sacrilegium  « profanation, impiété ».
sacripant|Empr. à l'ital. Sacripante , att. comme nom d'un roi de Circassie chez Boiardo, Berni et l'Arioste ; le sens 2 est dû à l'infl. de  chenapan *. 
sacoche|Empr. à l'ital. saccoccia  « petit sac » , dér. de  sacco  « sac » . 
sacolève|Empr. au vénit. sacoleva « voile de livarde; bateau du Levant muni de cette voile », empr. avec infl. de σ α ́ κ κ ο ς « sac », au gr. byz. σ α γ ο λ α ι ́ φ ε α « voiles », comp. de σ α ́ γ ο ς « manteau de soldat », à l'orig. « grossière étoffe de poils de chèvre », et de λ α ι ́ φ η « voile ». Voir  FEW  t. 11, p. 74a, et  Kahane Byzanz , 418. 
sacome|Empr. à l'ital. sacoma  «  id.  » , du lat.  sacoma  « contrepoids », lui-même empr. au gr. σ η ́ κ ω μ α «  id.  ».
sacrement|Empr. au lat. sacramentum , à l'orig. terme de dr. « dépôt fait aux dieux d'une certaine somme comme garantie de sa bonne foi ou de la bonté de sa cause dans un procès » ; ce dépôt s'accompagnant prob. d'une prestation de serment, le mot a pris le sens de « serment » , en partic. dans la lang. milit. et, par suite, dans la lang. de l'Église, il a signifié « lien sacré entre l'homme et Dieu, rite, vérité mystérieuse, mystère » et en partic. « rite sacramentel » et « l'Eucharistie » . 
sacristie|Empr. au lat. médiév. sacristia de même sens, v.  sacristain . 
sacrer|Empr. au lat. sacrare  « consacrer à une divinité; rendre sacré », de  sacer, sacrum  « sacré  »  cf. Ern. - Meillet : «  Sacer  désigne celui ou ce qui ne peut être touché sans être souillé, ou sans souiller »: de là le double sens de « sacré » ou « maudit ». L'empl. comme intensif blasphématoire de  sacré et l'ext. de sens de  sacrer  à « proférer des jurons »  peuvent être dus à l'attraction de  sacre  « brigand, homme sans foi ni loi » ,  cf. Gougenheim  ds  B. jeunes Rom. , n <sup o</sup 4, pp. 5-7. 
sagacité|Empr. au lat. sagacitas  « finesse de l'odorat », fig. « pénétration », dér. de  sagax , v.  sagace. 
sahel|Empr. à l'ar. sāḥil  « rivage de la mer, littoral; sirocco très fort, au Maroc » .
safari|Empr. au swahili safari « voyage, expédition; caravane, groupe de personnes voyageant ensemble »; et celui-ci à l'ar.  safar  « voyage » . 
saïga|Empr. au russe saïga, saïgak , et celui-ci au tchaghataï saiγak  .
safran|Empr. au lat. médiév. safranum  , et celui-ci à l'ar.  za farān  « safran ».
sagittaire|Empr. au lat. sc. sagittaria  , dér. du lat.  sagitta  « flèche » en raison de la forme des feuilles de cette plante. 
sagou|Empr. au malais sāgū « moelle de divers arbres »; 2 a pénétré en fr. par l'intermédiaire du port.  sagu , att. dep. 1552 . 
sagouin|Empr. au tupi saguim  par l'intermédiaire du port. att. dep. 1511 . 
saga|Empr. à l'a. nord. saga  « récit, conte » .
sagouine|Empr. au tupi saguim  par l'intermédiaire du port. att. dep. 1511 . 
sagace|Empr. au lat. sagax  « qui a l'odorat subtil » d'où fig. « pénétrant », « qui sait découvrir », dér. de  sagio  « sentir finement ». 
sajou|Empr. au tupi du Nord sapajou  . 
saké|Empr. au japonais.
saki|Empr. au japonais.
sakieh|Empr. à l'ar. sāqiya  « canal d'irrigation ; roue hydraulique mue par des bœufs », part. actif fém. subst. de  saqā « donner à boire, irriguer ». 
salace|Empr. au lat. salax  « lubrique, lascif », de  salire  au sens de « couvrir une femelle ». 
salacité|Empr. au lat. salacitas  « lasciveté ». 
salade|Empr. à l'ital. du Nord salada, salata , ital.  insalata  , part. passé de  salare, insalare  « saler », du lat. tardif  salare, insalare  «  id.  », dér. de  sal, -is  . Voir  FEW  t. 11, p. 82b et 84a, et  Hope , pp. 49-50. 
saisir|Empr. à l'a. h. all. *sazjan, cf.  le m. h. all.  setzen  « mettre quelqu'un en possession de quelque chose ». Le mot est att. vers 700 par le lat. médiév.  sacire  «  id.  » . Le sens originel en fr. est prob. « mettre quelqu'un en possession de quelque chose » d'où, par le pronom.  se saisir de, saisir  « prendre possession de » et « mettre quelque chose en sa main avec détermination ». Le sens jur. « mettre sous la main de la justice »  est att. en a. prov. dès 1278 [ms. du  xiv <sup e</sup s.] . 
saladelle|Empr. au prov. saladello  « statice », dér. de  salado  « salade » .
saisissant|Empr. à l'a. h. all. *sazjan, cf.  le m. h. all.  setzen  « mettre quelqu'un en possession de quelque chose ». Le mot est att. vers 700 par le lat. médiév.  sacire  «  id.  » . Le sens originel en fr. est prob. « mettre quelqu'un en possession de quelque chose » d'où, par le pronom.  se saisir de, saisir  « prendre possession de » et « mettre quelque chose en sa main avec détermination ». Le sens jur. « mettre sous la main de la justice »  est att. en a. prov. dès 1278 [ms. du  xiv <sup e</sup s.] . 
salicorne|Empr. au cat. salicorn  , plus prob. issu d'un b. lat.  salicorneum , comp. de  sal  « sel » et de  corneum  « en forme de corne », que d'orig. ar. Voir  Cor. - Pasc. ,  s.v. sal  et  FEW  t. 21, p. 154a.
salamalec|Empr. à l'ar. salām alayk  « paix sur toi » , formule de salutation employée par les musulmans. 
salamandre|Empr. au lat. salamandra  « salamandre  » et celui-ci au gr. σ α λ α μ α ́ ν δ ρ α. Au Moy. Âge, on attribuait à cet animal la faculté de vivre dans le feu, d'où les sens dér. Au sens 3,  cf.  lat.  salamandra  . Au sens 4,  cf.  anglo-amér.  salamander-stove  ,  salamander  . 
salep|Empr. au turc salep  « orchidée; salep », et celui-ci à l'ar.  ṯa <sup  207 </sup  lab , p. abrév. pour  ḫuṣā aṯ-ṯa <sup  207 </sup  lab  « orchis » .  Cf. Devic ;  Dozy  t. 1, p. 637a;  Lok ., n <sup o</sup 2001;  NED .
salique|Empr. au lat. médiév. salicus, lex salica  , dér. de  Salii , v.  salien <sup 2</sup . On note vers 1371-75:  loy  [...] dicte  salica  . 
salangane|Empr. à une lang. des Philippines: salamga, salangan  . Selon  Lok. , n <sup o</sup 1844,  König , p. 182 et  Cort. - Zolli , empr. au malais  sārang  « nid ».
salicaire|Empr. au lat. des botanistes salicaria  «  id.  » , dér. de  salix, salicis  « saule ». 
saloon|Empr. à l'angl. saloon  att. dep. 1728 et issu du fr.  salon * .  Saloon  est att. comme terme désignant un établissement ouvert au public dep. 1747. Le sens 2 fait réf. à l'anglo-amér. où  saloon  désigne en partic. un établissement où l'on vend des boissons alcoolisées . 
saltation|Empr. au lat. saltatio  « danse », dér. de  saltare  .
salpicon|Empr. à l'esp. salpicón  « plat froid de viande hachée assaisonnée avec du piment, du sel, de l'huile, du vinaigre et de l'oignon » , formé, comme  saupiquet* , à partir de  sal et de  picar  « hacher » .
saltatoire|Empr. au lat. saltatorius  « qui concerne la danse », dér. de  saltatum , supin de  saltare  .
saltatrice|Empr. au lat. saltator, -oris , dér. de  saltare  .
saltimbanque|Empr. à l'ital. saltimbanco  « acrobate de foire » , comp. de  salta  ,  in et  banco  « banc, estrade » . 
salubre|Empr. au lat. saluber  et  salubris  « utile à la santé, sain, salubre, bienfaisant »; dans la lang. chrét. « salutaire, qui procure le salut éternel ». 
salubrité|Empr. au lat. salubritas  « qualité de ce qui est salubre; moyens d'assurer la santé; état de santé, bon état du corps » 
salon|Empr. à l'ital. salone , att. au sens 1 dep. 1550 , dér., à l'aide du suff. augm.  -one  , de  sala  empr. au fr.  salle* . 
salse|Empr. à l'ital. salsa <sup 2</sup « petit volcan de boue et d'eau salée », empl. spécialisé de  salsa <sup 1</sup , corresp. au fr. « sauce », du lat.  salsa , fém. de  salsus  « salé » . 
salutaire|Empr. au lat. salutaris  « qui concerne la conservation, utile, avantageux, favorable ». 
salpêtre|Empr. au lat. médiév. salpetrae  littéral. « sel de pierre ». 
salsepareille|Empr. au port. salsaparrilha  , lui-même empr., avec altér. due à l'infl. de  salsa  « persil », à l'esp.  zarzaparrilla  « salsepareille », comp. de  zarza  « ronce » et de  parrilla  « treille », dér. dimin. de  parra  «  id.  »,  zarza  et  parra  étant d'orig. inc., prob. préromane .
salsifis|Empr. à l'ital. sassefrica  « salsifis » , aussi  salsefrica  , du lat. tardif  saxifrica , var. du lat.  saxifraga  « saxifrage »; cependant le passage du sens « saxifrage » plante de rocaille, à celui de « salsifis » s'explique mal . Le  r  de la forme  supra  1600, également présent dans de nombreuses formes dial., fait difficulté. Voir  FEW  t. 21, p. 128. 
salutation|Empr. au lat. salutatio  « salut, hommages, visite ». 
salvateur|Empr. au b. lat. eccl. salvator, -trix  « celui, celle qui sauve ». 
saltarelle|Empr. à l'ital. saltarello  « danse rapide, danse de la campagne romaine » , dér. de  saltare  . 
salvation|Empr. au b. lat. eccl. salvatio  « action de sauver, salut ».
saltateur|Empr. au lat. saltator, -oris , dér. de  saltare  .
salvatrice|Empr. au b. lat. eccl. salvator, -trix  « celui, celle qui sauve ». 
salve|Empr. à l'ital. salva , qui n'est pas att. dep. le  xvii <sup e</sup s. comme le croient  Bl. - W. <sup 1-5</sup et  FEW  t. 11, p. 132a, mais déjà au  xvi <sup e</sup s. , subst. fém. formé à partir du lat.  salve  . 
salvé|Empr. au lat. eccl. Salve  , déb. d'un hymne  mannus Contractus  d'apr.  Blaise Latin. Med. Aev. ), propr. « salut », impér. de  salvere  « saluer ».
sanctoral|Empr. au lat. médiév. sanctorale  « sanctoral, propre des saints » , dér. de  sanctorum  « des saints » .
sanctuaire|Empr. au lat. sanctuarium  « cabinet d'un roi » et en b. lat. eccl. « lieu sacré, sanctuaire »; les sens 7 sont une francisation d'empl. spéc. de l'angl.  sanctuary  , lui-même empr. au fr. . 
salvifique|Empr. au lat. salvificus  « qui procure le salut ».
samare|Empr. au lat. samara, samera  « semence d'orme », v. aussi  André Bot.  L'angl.  samara  est att. dep. 1577 ds  NED. 
sandale|Empr. au lat. eccl. sandalium  «  id. », du gr. σ α ν δ α ́ λ ι ο ν dimin. de σ α ́ ν δ α λ ο ν « sandale de bois, fixée par des courroies passant sur le pied ». 
samaritain|Empr. au lat. chrét. samaritanus  « de Samarie »,  Vulgate, Luc, Jean, supra. Cf.  la forme adaptée a. fr.  samariën  . 
samaritaine|Empr. au lat. chrét. samaritanus  « de Samarie »,  Vulgate, Luc, Jean, supra. Cf.  la forme adaptée a. fr.  samariën  . 
sancir|Empr. au gasc. sansi, samsi, soumsi  « tomber à l'eau et couler à fond » , a. prov.  somsir  « engloutir, absorber » , prob. d'un lat. médiév. * submersire  .
sandaraque|Empr. au lat. sandaraca  « réalgar, sulfure rouge d'arsenic », du gr. σ α ν δ α ρ α ́ κ η «  id. » , empr. oriental d'orig. inc. . Au sens 1 l'angl.  sandarac  est att. dep. 1398 ds  NED: sandaracha .
sambuque|Empr. au lat sambuca  « espèce de harpe; sorte de machine de guerre pour lancer des projectiles » et celui-ci au gr. σ α μ β υ ́ κ η mêmes sens; mot d'orig. orientale . 
sandastre|Empr. au lat. sandastros  ,  -i  «  id.  ».
sanderling|Empr. à l'angl. sanderling , désignant un petit échassier, att. seulement dep. 1602 mais prob. issu d'un vieil angl.  *sand-yrðling  comp. de  sand  « sable » et  yrðling  « laboureur, paysan » .
samit|Empr. au lat. médiév. examitus  , par aphérèse  samitus  « samit » , gr. médiév. ε ̔ ξ α ́ μ ι τ ο ς «  id.  » propr. « six fils ».  Cf.  la var.  samin  , issue de  samit  soit par substitution du suff.  -in  à la finale, soit par nasalisation de  -i-  sous l'infl. de la cons. précédente . 
sanctificateur|Empr. au b. lat. eccl. sanctificator  « sanctificateur ».  Cf.  les subst. fin  xiii <sup e</sup s.  saintefieur  , 1306  saintefierres  .
sanctification|Empr. au b. lat. sanctificatio  « sanctification ». 
sandjak|Empr. au turc sandjak « drapeau, étendard; subdivision d'une province dans l'Empire ottoman; gouverneur d'un sandjak » . Une grande partie des textes attestant le mot au  xvi <sup e</sup s. sont des trad. de textes ital. où le mot apparaissait soit sous la forme vénit.  sanzaco  , d'où les graph. fr.  sanzaque, sensaque,  etc., soit sous la forme de l'ital. commun  sangiacco,  d'où les graph. fr. de type  sangiaque, sanjacques,  etc.
samnite|Empr. au lat. Samnites , subst. masc. plur., nom d'un peuple habitant le Samnium, région montagneuse du centre de l'Italie, désignant en partic. des gladiateurs. 
sanctificatrice|Empr. au b. lat. eccl. sanctificator  « sanctificateur ».  Cf.  les subst. fin  xiii <sup e</sup s.  saintefieur  , 1306  saintefierres  .
samole|Empr. au lat. de Pline  samolus  « plante des lieux humides, non décrite, cueillie par les druides » peut-être mot celt. .
sanctifier|Empr. au b. lat. eccl. sanctificare  « sanctifier ». 
sandre|Empr. à l'all. Zander, Sander , de même sens que le fr., m. b. all.  sandât  .
sandwich|Empr. à l'angl. sandwich , att. en ce sens dep. 1762, tiré du nom de  John Montagu, Comte de Sandwich  [1718-1792] qui selon  Grosley ,  Londres , 1770, I, 262  avait passé 24 heures de suite à jouer en se restaurant de tranches de bœuf insérées entre deux tranches de pain . 
sanction|Empr. au lat. sanctio  « action de sanctionner, peine, punition », le sens 1 est empr. au b. lat. eccl.  sanctio  « édit qui sanctionne, rescrit  », plur. « décisions doctrinales des papes » . 
sanguin|Empr. au lat. sanguineus  « de sang; ensanglanté; de la couleur du sang ». 
sanguinaire|Empr. au lat. sanguinarius  « de sang »; fig. « qui aime à répandre le sang ». 
sanguine|Empr. au lat. sanguineus  « de sang; ensanglanté; de la couleur du sang ». 
sanguinolent|Empr. au lat. sanguinolentus  « sanglant ». 
santon|Empr. au prov. santoun  « statuette d'argile peinte représentant les personnages de la Nativité et destinée à figurer dans les crèches », propr. « petit saint » , dér. dimin. de  sanh, sant  « saint » ;  FEW  t. 11, p. 150a.
santonine|Empr. à l'occit. santonino , forme altérée issue du lat.  santonica  . Voir  FEW  t. 11, p. 187b.  Cf. santoline .
sanhédrin|Empr. à l'hébreu mishnaïque sanhedrι ̄n  « tribunal rabbinique » et celui-ci au gr. σ υ ν ε ́ δ ρ ι ο ν « assemblée siégeant; conseil; collège judiciaire; le Sénat ; le Sanhédrin  », dér. de σ υ ́ ν ε δ ρ ο ς « qui siège ensemble; membre d'une assemblée délibérante » . 
sanicle|Empr. à un lat. bot. *  sanicula  att. seulement au  xiii <sup e</sup s.  et dér. de  sanus à cause des vertus médicinales de cette plante.
sansevière|Empr. au lat. mod. sc. sansevieria  1794  du n. de Raimond de Sansgrio prince de  San Severo , érudit du  xviii <sup e</sup s. ; en angl. dès 1803: Chinese Sanseviera . 
sanie|Empr. au lat. sanies  « sang corrompu » . On rencontre au  xiii <sup e</sup s. la forme pic.  sainnie  , issue du lat. tardif  sania  , v.  FEW  t. 11, p. 184b. 
sanieux|Empr. au lat. saniosus  « couvert de sanie », dér. de  sanies  .
sapa|Empr. au lat. sapa  « vin cuit jusqu'à réduction de la moitié ou des deux tiers » .
sapajou|Empr. au tupi du Nord sapajou  . 
santal|Empr. au lat. médiév. sandalum  , et celui-ci à l'ar.  ṣandal , mot d'orig. indienne .  Sandal  a été refait en  santal  d'apr. le gr. σ α ́ ν τ α λ ο ν  de même orig. que l'arabe. 
sapientiaux|Empr. au lat. médiév. libri sapientiales  .
saphène|Empr. au lat. sc. saphena, sophena et celui-ci à l'ar.  sāfι ̄n ou  ṣāfin  , peut-être lui-même empr. au gr. σ α φ η ν η ́ ς « évident, clair ».
saphique|Empr. au lat. Sapphicus  « de Sapho »,  Sapphicus versus, Sapphicum metrum  « vers saphique », dér. de  Sappho  « Sapho, poétesse de Lesbos, que l'on disait homosexuelle » . 
saphir|Empr. au lat. class. sappirus , b. lat.  sapphirus  « saphir  », lui-même empr. au gr. σ α ́ π φ ε ι ρ ο ς, et celui-ci à une lang. sémit.  qui l'aurait empr. à une lang. de l'Inde . 
saponaire|Empr. au lat. médiév. des botanistes saponaria  «  id.  » , latinisation de l'a. fr.  savoniere  «  id.  » , dér. de  savon* ; suff.  -ière , v.  -ier .
sapide|Empr. au lat. sapidus  « qui a du goût, de la saveur »;  cf.  la forme pop.  sade , v.  maussade . 
sapience|Empr. au lat. sapientia , dans la lang. class. « intelligence, jugement; sagesse [gr. σ ο φ ι ́ α]; science, savoir, en partic. recherche de la vérité, philosophie [gr. φ ι λ ο σ ο φ ι ́ α] »; dans la lang. chrét. « sagesse, piété envers Dieu ; sagesse [que Dieu donne à ceux qui lui sont unis] ; don de découvrir les mystères; sagesse de Dieu [qui crée le monde et dispose de tout] ; le Saint-Esprit ; le Verbe  ». 3 est tiré du titre  Liber Sapientiae  . 
sardine|Empr. au lat. sardina  « sardine », dér. de  sarda  « sardine, poisson abondant sur les côtes de Sardaigne ». 
sarcocolle|Empr. au lat. sarcocolla  désignant la résine végétale et l'arbuste dont elle est extraite, gr. σ α ρ κ ο κ ο ́ λ λ α « résine » .
sarabande|Empr. à l'esp. zarabanda  « danse vive et gaie accompagnée de mouvements lascifs, en usage en Espagne aux  xvi <sup e</sup et  xvii <sup e</sup s. » , mot d'orig. obsc.  Cor.  rapporte plusieurs hyp.: −  zarabanda  remonterait au persan  sarband  « bandeau noué autour de la tête » , mais le sens « sorte de danse » n'est pas att. en persan. −  zarabanda  remonterait au persan  dastband  « danse au cours de laquelle on joint les mains » , par l'intermédiaire de l'ar.  dastaband  « jonction des mains au cours de la danse », att. au  x <sup e</sup s.; mais cette hyp. se heurte à des difficultés sém. et phonét. −  zarabanda  résulterait d'une déformation arg. intentionnelle  de l'esp.  zaranda  « crible, van », p. allus. au mouvement rythmique de cet ustensile. En concl.,  Cor.  pense que le n. de cette danse, inventée en Espagne au  xvi <sup e</sup s., est prob. de création indigène. 
sardoine|Empr. au lat. sardonyx  « onyx de Sardaigne », gr. σ α ρ δ ο ́ ν υ ξ «  id.  ».
sarcasme|Empr. au b. lat. sarcasmus  empl. par les grammairiens comme terme de rhét., gr. σ α ρ κ α σ μ ο ́ ς « rire amer, sarcasme » ;  cf.  chez  Fabri ,  Rhét. , 1521, l. I, p. 191:  sarcosmos  . 
sarigue|Empr. au tupi sarigué ; 1 représente une forme dial. tupi du Sud; 2 et 3 sont empr. par l'intermédiaire du port.  sariguea  ; la forme 2 est prob. due à une confusion de sons et de graph., le  ç  port. étant transcr. en fr. par  c  . Le genre fém. l'a emporté sur le masc. parce que la caractéristique la plus remarquable de cet animal est que la femelle porte les petits sur son dos, accrochés à sa longue queue préhensile. Voir  König,  pp. 186-187 et  FEW  t. 20, p. 77b. 
sarcome|Empr. au b. lat. sarcoma  «  id.  », gr. σ α ́ ρ κ ω μ α «  id.  »; en angl.  sarcome  est att. dès 1626 et  sarcoma  en 1657 .
sarisse|Empr. au gr. σ α ́ ρ ι σ σ α.
sarcophage|Empr. au lat. sarcophagus  adj. « qui consume les chairs »  cf. lapis sarcophagus  « pierre sarcophage  », et comme subst. masc. ou neutre « tombeau, sarcophage  », gr. σ α ρ κ ο φ α ́ γ ο ς « qui consume les chairs », v.  cercueil ; au sens 2 c  cf.  lat. sc.  sarcophaga  dep. 1826 . 
sardane|Empr. au cat. sardana , n. de danse att. dep. 1552 , prob. issu de  cerdana , fém. de  cerdà  « cerdan », cette danse étant prob. originaire de Cerdagne: aucun doc. anc. n'appuie cette hyp. mais la forme  cerdana  est utilisée pour désigner cette danse aux  xvi <sup e</sup - xvii <sup e</sup s., aussi bien en cat. qu'en esp. V.  Cor. - Pasc.  et  Alc. - Moll. 
sarmenteux|Empr. au lat. sarmentosus  « sarmenteux ».
saros|Empr. au gr. σ α ́ ρ ο ς ou σ α ρ ο ́ ς « cycle babylonien de 3 600 ans; cycle babylonien de 222 mois » , et celui-ci à l'akkadien  šâru, sâru  « cercle, cycle, chiffre parfait, 360, 3 600 ».  Cf.  angl.  sarus  « période de 3 600 ans » .
satire|Empr.  au lat. satura , var.  satira  , terme pop. appliqué à toutes sortes de « mélanges » [plat garni de diverses sortes de fruits et de légumes; ragoût], spéc. « pot-pourri scénique [B 1]; réunion de pièces didactiques variées de sujets et de mètres [Ennius]; [dep.  Lucilius , 103 av. J.-C.; B 2 a] poème critiquant les vices »;  cf. Bayet  1965, pp. 97-98. La  satura  dramatique [B 1] connue par Tite Live,  supra , et Valère Maxime, II, IV, 4, issue de la  fescinnina jocatio , a été renouvelée par l'imitation, la parodie des ,,ludions`` étrusques et confiée dès lors à des professionnels, v.  P. Boyancé  ds  R. Ét. anc.  t. 34, pp. 11-25 et J.-P.  Cèbe  ds  R. belge Philol. Hist.  t. 39, pp. 26-34. Dès l'époque lat.,  satira  subit l'infl. graph. de  satyra  , également perceptible en fr. dans le mot de base et ses dér. 
saroual|Empr. à l'ar. maghrébin sərwal  « pantalon très large », corresp. à l'ar. class.  sirwāl , empr. au persan  s̆alvār , même sens Vêt. , 1845, pp. 203-209;  Lok. , n <sup o</sup 1849;  FEW  t. 19, p. 160 et t. 20, pp. 109-110;  Baldinger Etymol.  1, n <sup o</sup 1839;  Frisk  t. 3, p. 176;  Vasmer  t. 3, p. 377;  NED ,  s.v. sherryvalies ;  TLF ,  s.v. charivari <sup 2</sup ).
satirique|Empr. au b. lat. satiricus « de satire, satirique » adj. et subst. 
sarouel|Empr. à l'ar. maghrébin sərwal  « pantalon très large », corresp. à l'ar. class.  sirwāl , empr. au persan  s̆alvār , même sens Vêt. , 1845, pp. 203-209;  Lok. , n <sup o</sup 1849;  FEW  t. 19, p. 160 et t. 20, pp. 109-110;  Baldinger Etymol.  1, n <sup o</sup 1839;  Frisk  t. 3, p. 176;  Vasmer  t. 3, p. 377;  NED ,  s.v. sherryvalies ;  TLF ,  s.v. charivari <sup 2</sup ).
sarracena|Empr. au lat. sc. Sarracena  , n. créé par Tournefort en l'honneur du médecin fr. établi au Canada Michel  Sarrasin  ; Linné a introduit la var.  Sarracenia  . 
sarracenia|Empr. au lat. sc. Sarracena  , n. créé par Tournefort en l'honneur du médecin fr. établi au Canada Michel  Sarrasin  ; Linné a introduit la var.  Sarracenia  . 
satisfaction|Empr. au lat. satisfactio  « action d'acquitter  », « excuse, justification, disculpation, amende honorable », « satisfaction, réparation ». 
satellite|Empr. au lat. satelles, -itis  « garde du corps, soldat » « compagnon, serviteur », « auxiliaire, complice ». 
satisfactoire|Empr. au lat. scolast. satisfactorius  « même sens ».
sarracénie|Empr. au lat. sc. Sarracena  , n. créé par Tournefort en l'honneur du médecin fr. établi au Canada Michel  Sarrasin  ; Linné a introduit la var.  Sarracenia  . 
sati|Empr. au skr. satι ̄ « femme de qualité, femme chaste, épouse fidèle » , peut-être par l'intermédiaire de l'angl. où la transcr.  suttee  est plus cour., à côté de  sati, satti  et  shuttee  .
satisfaire|Empr. au lat. satisfacere  « satisfaire à, s'acquitter de, exécuter », « satisfaire un créancier », « donner satisfaction à quelqu'un, lui faire agréer des excuses ». 
sarrasin|Empr. au lat. médiév. Saraceni , nom des populations musulmanes du Proche-Orient, d'Afrique du Nord et d'Espagne, et celui-ci au gr. byz. Σ α ρ α κ η ν ο ι ́, att. dep. le  vi <sup e</sup s. comme appellation gén. des Arabes ; en gr. tardif, Σ α ρ α κ η ν ο ι ́ désignait une population nomade d'Arabie, mentionnée au  ii <sup e</sup s. par Ptolémée , d'où le b. lat.  Sarraceni  . Le gr. Σ α ρ α κ η ν ο ι ́ doit prob. être rattaché au topon.  Saraka  , n. d'une ville d'Arabie heureuse citée par Ptolémée, et d'une région de la péninsule du Sinaï mentionnée au  vi <sup e</sup s. par Étienne de Byzance , et non à l'ar.  šarqι ̄ « oriental », dér. de  šarq  « Orient » . 
satiable|Empr. au lat. satiabilis  « qui peut être rassasié  ».
satisfaisant|Empr. au lat. satisfacere  « satisfaire à, s'acquitter de, exécuter », « satisfaire un créancier », « donner satisfaction à quelqu'un, lui faire agréer des excuses ». 
sarrasine|Empr. au lat. médiév. Saraceni , nom des populations musulmanes du Proche-Orient, d'Afrique du Nord et d'Espagne, et celui-ci au gr. byz. Σ α ρ α κ η ν ο ι ́, att. dep. le  vi <sup e</sup s. comme appellation gén. des Arabes ; en gr. tardif, Σ α ρ α κ η ν ο ι ́ désignait une population nomade d'Arabie, mentionnée au  ii <sup e</sup s. par Ptolémée , d'où le b. lat.  Sarraceni  . Le gr. Σ α ρ α κ η ν ο ι ́ doit prob. être rattaché au topon.  Saraka  , n. d'une ville d'Arabie heureuse citée par Ptolémée, et d'une région de la péninsule du Sinaï mentionnée au  vi <sup e</sup s. par Étienne de Byzance , et non à l'ar.  šarqι ̄ « oriental », dér. de  šarq  « Orient » . 
satiété|Empr. au lat. satietas  « rassasiement, satiété, dégoût, ennui », « quantité suffisante ». 
satisfait|Empr. au lat. satisfacere  « satisfaire à, s'acquitter de, exécuter », « satisfaire un créancier », « donner satisfaction à quelqu'un, lui faire agréer des excuses ». 
satisfaite|Empr. au lat. satisfacere  « satisfaire à, s'acquitter de, exécuter », « satisfaire un créancier », « donner satisfaction à quelqu'un, lui faire agréer des excuses ». 
satrape|Empr. au lat. satrapes  « gouverneur de province chez les Perses », gr. σ α τ ρ α ́ π η ς «  id.  », du persan  khshatrapâ  « officier du roi ». 
sarrau|Empr. au m. h. all. sarroc  « vêtement militaire; surplis ».  FEW  t. 17, p. 16. 
satan|Empr. au lat. chrét. Satan  ,  Satanas « Satan, l'esprit du mal », gr. Σ α τ α ̃ ν , Σ α τ α ν α ̃ ς , empr. à l'hébr. biblique  śāṭān  « adversaire, accusateur; Satan ». 
satrapie|Empr. au lat. satrapia  « satrapie, province gouvernée par un satrape », gr. σ α τ ρ α π ε ι ́ α «  id.  ». 
sarrazin|Empr. au lat. médiév. Saraceni , nom des populations musulmanes du Proche-Orient, d'Afrique du Nord et d'Espagne, et celui-ci au gr. byz. Σ α ρ α κ η ν ο ι ́, att. dep. le  vi <sup e</sup s. comme appellation gén. des Arabes ; en gr. tardif, Σ α ρ α κ η ν ο ι ́ désignait une population nomade d'Arabie, mentionnée au  ii <sup e</sup s. par Ptolémée , d'où le b. lat.  Sarraceni  . Le gr. Σ α ρ α κ η ν ο ι ́ doit prob. être rattaché au topon.  Saraka  , n. d'une ville d'Arabie heureuse citée par Ptolémée, et d'une région de la péninsule du Sinaï mentionnée au  vi <sup e</sup s. par Étienne de Byzance , et non à l'ar.  šarqι ̄ « oriental », dér. de  šarq  « Orient » . 
sarrazine|Empr. au lat. médiév. Saraceni , nom des populations musulmanes du Proche-Orient, d'Afrique du Nord et d'Espagne, et celui-ci au gr. byz. Σ α ρ α κ η ν ο ι ́, att. dep. le  vi <sup e</sup s. comme appellation gén. des Arabes ; en gr. tardif, Σ α ρ α κ η ν ο ι ́ désignait une population nomade d'Arabie, mentionnée au  ii <sup e</sup s. par Ptolémée , d'où le b. lat.  Sarraceni  . Le gr. Σ α ρ α κ η ν ο ι ́ doit prob. être rattaché au topon.  Saraka  , n. d'une ville d'Arabie heureuse citée par Ptolémée, et d'une région de la péninsule du Sinaï mentionnée au  vi <sup e</sup s. par Étienne de Byzance , et non à l'ar.  šarqι ̄ « oriental », dér. de  šarq  « Orient » . 
saturateur|Empr. au b. lat. saturator  « celui qui rassasie » , du lat. class.  saturatum , supin de  saturare , v.  saturer . 
saturation|Empr. au b. lat. saturatio  « rassasiement » , du lat. class.  saturatum , supin de  saturare , v.  saturer . 
saturé|Empr. au lat. saturare  « rassasier, assouvir », de  satur  « rassasié », dér. de  satis  « assez ». 
saturer|Empr. au lat. saturare  « rassasier, assouvir », de  satur  « rassasié », dér. de  satis  « assez ». 
saturnales|Empr. au lat. saturnalia  « fêtes en l'honneur du dieu Saturne; jours de réjouissances, de liberté absolue », neutre plur. de l'adj.  saturnalis  « de Saturne », dér. de  Saturnus , v. l'étymol. de  saturne . 
saturne|Empr. au lat. Saturnus , n. d'un dieu  et d'une planète. Les alchimistes ont donné le n. de  saturne  au plomb parce que l'on considérait ce métal comme un métal froid , v.  FEW  t. 11, p. 254b. 
saturnie|Empr. au lat. sc. mod. saturnia  «  id.  » , du lat. class.  Saturnia  « fille du dieu Saturne », de  Saturnus , v. l'étymol. de  saturne .
saucisson|Empr. à l'ital. salsiccione , att. au sens 1 dep. la 2<sup e</sup moit. du  xiv <sup e</sup s. , dér. augm. de  salsiccia  . 
satyre|Empr. au lat. Satyrus , compagnon de Bacchus, avec les oreilles, la queue, les pieds de chèvre; du gr. Σ α ́ τ υ ρ ο ς «  id.  ». Le fém.  satyre  « drame satyrique »  est empr. au lat.  satyrus , lui-même empr. au gr. σ α ́ τ υ ρ ο ς «  id.  », le genre fém. étant prob. dû à l'infl. de  satire* . 
saur|Empr. au m. néerl. soor  «  séché ». 
saure|Empr. au m. néerl. soor  «  séché ». 
satyriasis|Empr. au b. lat. méd. satyriasis  «  id.  », lui-même empr. au gr. σ α τ υ ρ ι ́ α σ ι ς «  id.  », dér. de σ α τ υ ρ ι α ́ ω « être atteint de priapisme », dér. de σ α ́ τ υ ρ ο ς, v.  satyre .
satyrique|Empr. au lat. satyricus  « qui concerne les Satyres; qui appartient au drame satyrique » , du gr. σ α τ υ ρ ι κ ο ́ ς «  id.  », dér. de σ α ́ τ υ ρ ο ς, v.  satyre . 
scabieuse|Empr. au lat. médiév. scabiosa  « scabieuse » , subst. fém. tiré du lat.  scabiosus  « galeux » , cette plante ayant été utilisée comme remède contre la gale. Voir  FEW  t. 11, p. 263a. 
savane|Empr. à l'esp. çabana  , lui-même empr. au taino de Haïti. Voir  König , p. 188 et  FEW  t. 20, p. 85a. 
scabieux|Empr. au lat. scabiosus  « rugueux » et « galeux », dér. de  scabies  « gale ». 
saxatile|Empr. au lat. saxatilis  « qui se tient dans la pierre ».
scabreux|Empr. au lat. tardif scabrosus  « rude, raboteux, inégal; sale », dér. de  scaber  «  id.  ».  FEW  t. 11, p. 262. 
scalde|Empr. aux lang. scand. .  NED, s.v. skald . 
saxifrage|Empr. au lat. saxifraga  « plante employée pour dissoudre les calculs », « plante de rocaille non déterminée » . 
scalène|Empr. au gr. σ κ α λ η ν ο ́ ς, propr. « boiteux », d'où « impair, inégal ». 
scalpel|Empr. au lat. de même sens scalpellum , dimin. de  scalprum  « outil tranchant » auquel est empr. la forme  scalpre. 
saxon|Empr. au b. lat. Saxo, -onis  « Saxon, habitant du Nord de la Germanie », au Moy. Âge, on utilisait une forme plus pop.  Saisnes  . 
scalper|Empr. à l'angl. to scalp  « détacher le cuir chevelu par incision pour le prendre comme trophée » , de  scalp  « cuir chevelu » . 
saxonne|Empr. au b. lat. Saxo, -onis  « Saxon, habitant du Nord de la Germanie », au Moy. Âge, on utilisait une forme plus pop.  Saisnes  . 
scammonée|Empr. au lat. scammonea  ou  scammonia , gr. σ κ α μ μ ω ν ι ́ α.
scamonée|Empr. au lat. scammonea  ou  scammonia , gr. σ κ α μ μ ω ν ι ́ α.
saynète|Empr. à l'esp. sainete , att. dep. 1385 au sens de « petit morceau de nourriture donné en récompense à un faucon de chasse » , puis « toute bouchée agréable au goût », puis « toute chose plaisante », et enfin « pièce bouffonne en un acte qu'on donnait avant le deuxième acte d'une comédie » , dér. dimin. de  saín  « graisse, spécialement des animaux », du lat. vulg. * saginum  . 
scandale|Empr. au lat. eccl. scandalum  « ce sur quoi on trébuche » au propre et au fig. dep.  iv <sup e</sup - v <sup e</sup s. ds  Blaise Lat. chrét. , spéc.  petra scandali  « pierre d'achoppement »  ibid. , « abomination, objet de déplaisir ou de colère »  ibid. , spéc. « scandale  »  ibid. , « ce qui fait tomber dans le péché, occasion de péché, de la perte de la vraie foi » déb.  iii <sup e</sup s.,  ibid. , « dispute, rixe, bataille »  vi <sup e</sup s.,  ibid. , également en lat. médiév. « machination, mauvais dessein » 876 ds  Nierm. , « désarroi, perturbation, scission » 817,  ibid. , « esclandre » 829,  ibid. , « calomnie »  ca  1180 ds  Latham , du gr. σ κ α ́ ν δ α λ ο ν « piège placé sur le chemin pour faire trébucher » ,,d'où sous l'infl. d'empl. sémitiques, au fig. « occasion de scandale, péché, incitation à pécher » − LXX, NT −`` . 
scandaleux|Empr. au lat. tardif scandalosus  « abominable »  vi <sup e</sup - vii <sup e</sup s. ds  Gaff. , dér. de  scandalum , v.  scandale . 
sbire|Empr. à l'ital. sbirro , att. au sens 1 dep. 1518-25 , dér. de  birro , même sens, dep.  xiv <sup e</sup s., du lat.  birrus, burrus  « rougeâtre » , prob. à cause de la couleur de l'uniforme de ces archers . 
scandalisé|Empr. au b. lat. eccl. scandalizare  « faire tomber dans le péché, être une occasion de chute pour quelqu'un » 1<sup re</sup moit.  iii <sup e</sup s. ds  Blaise Lat. chrét. , « heurter, choquer, irriter »  iv <sup e</sup s.,  ibid. , également en lat. médiév. « abaisser, humilier »  ix <sup e</sup s. ds  Nierm. , « jeter dans le désarroi » 833,  ibid. , du gr. σ κ α ν δ α λ ι ́ ζ ω « inciter au mal, scandaliser » LXX, NT et au passif « être offensé » , de σ κ α ́ ν δ α λ ο ν, v.  scandale. 
scandaliser|Empr. au b. lat. eccl. scandalizare  « faire tomber dans le péché, être une occasion de chute pour quelqu'un » 1<sup re</sup moit.  iii <sup e</sup s. ds  Blaise Lat. chrét. , « heurter, choquer, irriter »  iv <sup e</sup s.,  ibid. , également en lat. médiév. « abaisser, humilier »  ix <sup e</sup s. ds  Nierm. , « jeter dans le désarroi » 833,  ibid. , du gr. σ κ α ν δ α λ ι ́ ζ ω « inciter au mal, scandaliser » LXX, NT et au passif « être offensé » , de σ κ α ́ ν δ α λ ο ν, v.  scandale. 
scandé|Empr. au lat. des grammairiens scandere  « lever et baisser le pied », « battre la mesure », « scander des vers ». 
scarole|Empr. au lat. tardif escariola  « sorte d'endive » , dér. dimin. du lat.  escarius  « bon à manger », dér. de  esca  « nourriture ». Voir  A. Thomas  ds  Romania  t. 36, pp. 613-614 et  FEW  t. 3, p. 245b.
scat|Empr. à l'angl.-amér. scat  syll. à sonorité expressive utilisée comme subst. pour désigner le style de chant avec de telles syll. .
scander|Empr. au lat. des grammairiens scandere  « lever et baisser le pied », « battre la mesure », « scander des vers ». 
scénario|Empr. à l'ital. scenario , att. au sens 1 a dep. le  xvii <sup e</sup s. , dér. de  scena  . 
scarabée|Empr. au lat. scarabaeus  « escarbot » , altér. du gr. κ α ́ ρ α β ο ς, v.  carabe . 
scène|Empr. au lat. scaena  « scène d'un théâtre, théâtre », « scène publique, scène du monde », « mise en scène, comédie, intrigue », « partie d'un acte », gr. σ κ η ν η ́ « construction en bois, couverte, où on jouait les pièces de théâtre », d'où « partie de la scène où jouaient les acteurs », « fiction de théâtre », d'où « fiction, mensonge ». 
scaramouche|Empr. à l'ital. Scaramuccio , n. d'un personnage de la Commedia dell'Arte, formé à partir de  scaramuccia  « escarmouche » , et popularisé en France sous le règne de Louis XIII et la Régence par l'acteur Tiberio Fiorelli ou Fiorillo. Voir  Hope , pp. 302-303. 
scanner|Empr. à l'angl. scanner  « celui qui scrute, qui examine avec précision »  att. dep. 1927 pour désigner tout appareil permettant l'examen systématique des différentes parties de quelque chose  et dér. de  to scan  « étudier le rythme d'un vers, scander » d'où « faire la critique de, passer au crible pour juger la valeur de », du lat.  scandere  . L' Arrêté du 7 déc. 1978  recommande l'empl. du terme  scanographe  et de son dér.  scanographie en méd. où sont également empl. les termes  tomodensitomètre  et le dér.  tomodensitométrie pour désigner l'appareillage d'examen et l'examen lui-même.
scare|Empr. au lat. scarus  «  id.  », lui-même empr. au gr. σ κ α ́ ρ ο ς «  id.  ».
scénique|Empr. au lat. scaenicus  « de la scène, de théâtre », gr. σ κ η ν ι κ ο ́ ς « de théâtre, scénique ». 
scarieux|Empr. au lat. sc. mod. scariosus  «  id.  » , à rattacher peut-être au lat. médiév.  scaria  « bouton » , gr. ε ̓ σ χ α ́ ρ α, v.  escarre <sup 1</sup .
scénographie|Empr. au lat. scaenographia  « coupe en perspective », gr. σ κ η ν ο γ ρ α φ ι ́ α « récit ou description dramatique », « décor de peinture pour le théâtre ».
scansion|Empr. au lat. des grammairiens scansio  « échelle ascendante des sons, gamme ».
sceptique|Empr. au gr. σ κ ε π τ ι κ ο ́ ς « qui observe, qui réfléchit »; « les philosophes sceptiques, c'est-à-dire ceux qui font profession d'observer, de ne rien affirmer, en parlant des pyrrhoniens ». 
scaphoïde|Empr. au gr. σ κ α φ ο ε ι δ η ́ ς « qui ressemble à un bateau allongé », comp. de σ κ α ́ φ η « objet creux, barque » et de ε ι ̃ δ ο ς « aspect, forme ». 
sceptre|Empr. au lat. sceptrum  « sceptre », « trône, royaume, royauté », « suprématie », gr. σ κ η ̃ π τ ρ ο ν « bâton pour s'appuyer », « bâton de commandement, de roi, de chef ». 
schah|Empr. au persan šāh  « roi » ;  cf. échec ,  padischah . 
schappe|Empr. à l'alémanique schappe , de même sens que le fr. Voir  FEW  t. 17, p. 28b.
schéma|Empr. au lat. schema, -atis  « attitude », « figure géométrique », « figure de rhétorique », gr. σ χ η ̃ μ α, -α τ ο ς « forme, figure », « caractères extérieurs du discours », « forme métrique de l'expression », « figure géométrique », « figure de rhétorique ». 
schisme|Empr. au b. lat. ecclés. schisma , gr. σ χ ι ́ σ μ α, dér. de σ χ ι ́ ζ ε ι ν « fendre ». La graphie lat.  schisme  est att. en 1534 chez  Rabelais, Gargantua , XVI, éd. R. Calder, M. A. Screech et V.-L. Saulnier, p. 112. 
schiste|Empr. au lat. schistos  , propr. « pierre fendue », empr. au gr. σ χ ι σ τ ο ́ ς « fendu; qu'on peut fendre », dér. de σ χ ι ́ ζ ω « fendre; séparer en fendant ». 
schème|Empr. au lat. schema, -atis  . 
schéol|Empr. à l'hébr. biblique sh <sup  ĕ </sup  ōl  « séjour des morts ».
schérif|Empr. à l'ar.  šarīf  « noble, éminent » , fém.  šarīfa,  plur.  šurafā'  , de la racine  šarafa  « être élevé, noble, éminent; exceller en noblesse, en gloire » .  
schibboleth|Empr. à l'hébr. biblique shibbōlet  « épi », mot utilisé par les gens de Galaad pour reconnaître ceux d'Ephraïm, qui prononçaient  sibbōlet , et qu'ils égorgeaient aussitôt .
schlague|Empr. à l'all. Schlag  « coup ». 
schilling|Empr. à l'all. Schilling , désignant diverses monnaies des pays de langue germ.; le schilling est l'unité monétaire autrichienne dep. le 19 déc. 1924 . 
schismatique|Empr. au b. lat. ecclés. schimaticus , gr. σ χ ι σ μ α τ ι κ ο ́ ς dér. de  schisma  . b) reproduit la graphie latine. 
schlass|Empr. à l'all. région. schlass  « mou, fatigué » . Le mot n'est pas att. ds  E. Martin, H. Lienhart, Wörterbuch der elsässischen Mundarten , Strasbourg, 1899-1907. 
schuss|Empr. au sens 1 a à l'all. Schuβ ,  comp. de  Schuβ « coup ; action de lancer rapidement, avec force ; mouvement rapide, élan » et de  Fahrt  « trajet, voyage, promenade ». 
scintiller|Empr. au lat. scintillare  « avoir une lueur scintillante; étinceler, briller », dér. de  scintilla  « étincelle, point brillant ». 
schwa|Empr. à l'hébr. rabbinique  š əva,  altération  du subst. hébr. biblique  šāv'  « rien, vide; vain », nom donné vers le  ix <sup e</sup s. par les massorètes tibériens à la voyelle [ə] ou à l'absence de voyelle . Au sens 2, angl.  sheva  en 1888 ds  NED. 
sciographie|Empr. au lat. d'époque impériale sciographia , terme d'archit. lui-même du gr. σ κ ι ο γ ρ α φ ι α ́ ou σ κ ι α γ ρ α φ ι ́ α « dessin ou peinture avec une juste distribution d'ombre et de lumière »  d'où « dessin en perspective ».
scille|Empr. au lat. scilla  , qui a d'abord désigné la scille ou oignon marin, puis des plantes à bulbe . 
schnick|Empr. au dial. all. de Lorraine  ou d'Alsace  schnick  « eau-de-vie », issu du verbe dial. all.  schnicken  « effectuer un mouvement rapide avec les mains ou les jambes » . 
science|Empr. au lat. scientia, -ae  « connaissance, savoir, connaissances théoriques ». 
scillitique|Empr. au lat. scilliticus « fait avec de la scille ».
sciène|Empr. au lat. sciaena  « femelle de l'ombre », empr. au gr. dér. de σ κ ι ́ α ι ν α « ombre ». 
scinder|Empr. au lat. class. scindere  « déchirer, fendre » pour avoir un verbe corresp. à  scission * . 
scirpe|Empr. au lat. d'époque impériale scirpus  « jonc », d'où le lat sc.  scirpus , 1700 .
scinque|Empr. au lat. scincus , n. d'un lézard, empr. au gr. σ κ ι ́ γ κ ο ς de même sens. 
scissile|Empr. au lat. d'époque impériale scissilis  « fissile, qui se partage en lames », formé sur le supin  scissum , de  scindere , v.  scinder. 
scission|Empr. au b. lat. scissio  « coupure, division », formé sur le supin  scissum , de  scindere , v.  scinder . 
schooner|Empr. à l'anglo-amér. schooner dont l'orig. est incertaine: il daterait de 1713 et serait dér. du terme dial. du Nord de l'Angleterre et de Scandinavie  to scoon, scun  « effleurer la surface de l'eau », selon une anecdote rapportée pour la 1<sup re</sup fois en 1790 . 
schorre|Empr. au m. néerl. schor  « terrain d'alluvion ».
scientifique|Empr. au b. lat. scientificus, -a, -um  « qui fait, qui produit la science », dér. de  scientia introd. par Boèce à côté de  scientialis  « propre à la science » qui n'a pas survécu . 
scintillation|Empr. au lat. scintillatio  « éblouissement », dér. de  scintillare , v.  scintiller . 
scissure|Empr. au lat. d'époque impériale scissura  « coupure, division »; « égratignure, déchirure », formé sur le supin  scissum , de  scindere , v.  scinder . 
sclérotique|Empr. au lat. médiév. sclerotica , av. 1250 «  id.  » ds  Latham , dér. du gr. σ κ λ η ρ ο ́ τ η ς « dureté, rudesse », dér. de σ κ λ η ρ ο ́ ς « dur au toucher ». 
scolaire|Empr. au b. lat. scholaris  « d'école » ; dér. du lat. class.  schola  « école ». 
sclérose|Empr. au gr. σ κ λ η ́ ρ ω σ ι ς « durcissement », de σ κ λ η ρ ο υ ̃ ν « rendre dur », dér. de σ κ λ η ρ ο ́ ς « dur au toucher ». 
scolarité|Empr. au lat. médiév. scholaritas  « état d'écolier » , dér. de  scholaris  .
scolastique|Empr. au lat. class. et b. lat. scholasticus  adj. « d'école », subst. « rhéteur; lettré, savant; avocat; étudiant, écolier », lat. médiév. « chef d'une école ecclésiastique », empr. au gr. σ χ ο λ α σ τ ι κ ο ́ ς adj. « qui a du loisir; qui consacre son loisir à l'étude; qui concerne les gens d'étude; qui concerne l'étude ou l'école, propre à l'école », subst. « homme d'étude; péj.: pédant; avocat », dér. de σ χ ο λ α ́ ζ ω « avoir du loisir; consacrer son loisir à; se consacrer à l'étude; donner un enseignement », lui-même dér. de σ χ ο λ η ́ . 
scoliaste|Empr. au gr. médiév. σ χ ο λ ι α σ τ η ́ ς « commentateur », , dér. de σ χ ο λ ι α ́ ζ ω « écrire des commentaires sur » , dér. de σ χ ο ́ λ ι ο ν . 
scolie|Empr. au gr. σ χ ο ́ λ ι ο ν « explication, commentaire », dér. de σ χ ο λ η ́ « repos, loisir; étude, école » . 
scorie|Empr. au lat. scoria  « scorie », lui-même empr. au gr. σ κ ω ρ ι ́ α «  id.  ». 
scriptes|Empr. à l'angl. script  « écrit, document écrit », du lat.  scriptum , part. passé subst. de  scribere  . Att. dep. 1937  p. abrév. de  script writing ou  print script  .
scoliose|Empr. au gr. σ κ ο λ ι ́ ω σ ι ς « action de rendre oblique ou tordu », dér. de σ κ ο λ ι ο ́ ο μ α ι « être tordu », dér. de σ κ ο λ ι ο ́ ς « tordu, de travers ».
scripteur|Empr. au lat. scriptor  « secrétaire, écrivain, rédacteur ». 
scolopendre|Empr. au lat. scolopendra  « scolopendre ; scolopendre de mer ou néréide », et celui-ci au gr. σ κ ο λ ο ́ π ε ν δ ρ α mêmes sens.
scolyte|Empr. au lat. sc. scolytus  , prob. formé d'apr. le gr. σ κ ο λ υ ́ π τ ω « déchirer, arracher » . 
scriptural|Empr. au lat. eccl. scripturalis  « qui se rapporte à l'Écriture sainte » , dér. de  scriptura  pris au sens de « Écriture sainte, la Bible ».
scombre|Empr. au lat. scomber, -bri  « scombre, maquereau », gr. σ κ ο ́ μ β ρ ο ς «  id.  ». 
scorpène|Empr. au lat. scorpaena  désignant un poisson de mer, gr. σ κ ο ́ ρ π α ι ν α «  id.  ». 
sconce|Empr. à l'angl. skunks « mouffette », lui-même empr. à une lang. algonquine:  shi-gaw  « putois » ,  segankw  .
scorpioïde|Empr. au gr. σ κ ο ρ π ι ο ε ι δ η ́ ς « semblable à un scorpion », n. d'une plante chez Dioscoride; au sens 1  cf.  une attest. de Paré qui transcrit la forme latinisée désignant une plante qui sert à composer un remède pour soigner les piqûres de scorpion: « pour un singulier remede on y applique l'herbe nommee  Scorpioïdes , dont on a pris le nom » . Le gr. σ κ ο ρ π ι ́ ο ς désigne également une plante, d'où le b. lat. des botanistes  scorpio  .
scrofule|Empr. au b. lat. scrofulae  « écrouelles », v. ce mot. 
scons|Empr. à l'angl. skunks « mouffette », lui-même empr. à une lang. algonquine:  shi-gaw  « putois » ,  segankw  .
scorpion|Empr. au lat. scorpio, scorpionis  « insecte venimeux », « la constellation du scorpion » et « sorte de poisson de mer », gr. σ κ ο ρ π ι ́ ο ς «  id.  ». 
scratch|Empr. à l'angl. scratch  « coup d'ongle, griffure » d'où « marque, coup de plume », déverbal de  to scratch att. dans le domaine du sport dep. 1778 au sens de « tracé dans le sol d'une ligne de démarcation ou de départ », d'où, plus spéc., « ligne de départ des concurrents non avantagés d'une course à handicap »  et « concurrent non avantagé »  ou « compétition sans handicap » , v.  NED.  Au sens D, déverbal de  scratcher *. 
sconse|Empr. à l'angl. skunks « mouffette », lui-même empr. à une lang. algonquine:  shi-gaw  « putois » ,  segankw  .
scoop|Empr. à l'anglo-amér. scoop  subst. du verbe  to scoop  « écoper, ramasser » d'où « ramasser plus que d'autres ou avant les autres, s'approprier aux dépens des autres, dominer, vaincre »  et dans l'arg. des journalistes amér. « couper l'herbe sous les pieds à, devancer »  att. à l'empl. subst. dep. 1874 . L'Arrêté du 10 oct. 1985 recommande l'empl. de  exclusivité  et  primeur  comme équivalents .
scriban|Empr. au néerl. schrijfbank  « pupitre ».  FEW  t. 17, p. 58a.
scooter|Empr. à l'angl. scooter  désignant le véhicule motorisé à deux roues  appelé aussi  motor-scooter  comp. de  motor , de même orig. que le fr.  moteur * et de  scooter  « celui qui démarre vite, qui file » d'où « petit véhicule ou bateau très maniable » et « trottinette d'enfant », dér. de  to scoot  « démarrer brusquement, courir vite, filer » forme amér. d'un verbe angl.  to scout  d'orig. obsc. .
scotch|Empr. à l'angl. Scotch  « écossais » dans le syntagme  Scotch whisky  « whisky écossais »  et, p. ell.  Scotch  « whisky écossais » . 
scribe|Empr. au lat. scriba  « copiste, scribe, secrétaire »; en lat. chrét. « docteur de la loi, chez les Juifs », dér. de  scribere  « écrire » . 
scrub|Empr. à l'angl. scrub  att. dep. 1805 comme terme désignant des étendues couvertes de végétation touffue  en Australie ou en Nouvelle-Zélande .  Scrub  « arbre bas et rabougri, buisson », att. dep. 1398, est une var. de  shrub  « arbrisseau, arbuste, taillis » issu du vieil-angl. att. par une forme fém.  scrybb  . 
scotie|Empr. au lat. scotia  «  id.  », du gr. σ κ ο τ ι ́ α «  id.  », d'abord « ténèbres, obscurité », dér. de σ κ ο ́ τ ο ς « obscurité, ténèbres ».  Cf.  l'angl.  scotia  «  id.  » dep. 1563 ds  NED . 
scrubber|Empr. à l'angl. scrubber , dér. de  to scrub  « récurer, frotter, nettoyer, laver » dont les corresp. m. b. all. et m. néerl. laissent supposer une orig. germ. mais dont l'étymon vieil-angl. n'est pas établi.  Scrubber  est att. dep. 1853 comme terme désignant un dispositif d'épuration du gaz de houille . 
scorbut|Empr. au lat. méd. scorbutus  , lui-même prob. empr. au m. néerl. * scôrbut  ,  cf.  le m. b. all.  schorbuk  ; le néerl. est prob. empr., par l'intermédiaire de l'a. suéd.  skörbjug , à l'a. nord.  skyrbjúgr  « scorbut », comp. de  skyr  « lait caillé » et de  bjúgr  « œdème »: on attribuait à la grande consommation de lait caillé par les marins pendant leurs voyages l'apparition d'œdèmes. Le mot est d'abord att. en fr. comme mot étranger: 1557  scuerbuyck  donné comme mot néerl. et fris., 1561  schoerbuck  dans une trad. du suéd., v.  Arv. , p. 454  sqq ;  FEW  t. 17, p. 63. 
scrupule|Empr. au lat. scrupulum  « petit caillou; 24<sup e</sup partie de l'once », en gén. « la plus petite division d'une unité de mesure ».
scotome|Empr. au lat. tardif scotoma, -atis  « vertige, éblouissement »  vi - vii <sup e</sup s. ds  Blaise Lat. chrét. , du gr. σ κ ο ́ τ ω μ α, -α τ ο ς «  id.  », de σ κ ο τ ω ̃ « aveugler par un éblouissement » d'où au passif « avoir le vertige », d'abord « couvrir de ténèbres », de σ κ ο ́ τ ο ς « obscurité, ténèbres ».  Cf.  l'angl.  scotoma  «  id.  » dep. 1543 ds  NED. Cf.  les formes  scotomie  «  id.  »  xv <sup e</sup s.  − 1853  Besch.  et  scotodynie  «  id.  » dep. 1814 .
script|Empr. à l'angl. scrip abrév. de  subscription  dans le syntagme  subscription receipt désignant ce type de document de souscription d'un prêt, d'où, p. ext., un certificat de possession de parts dans une société, peut-être à l'orig. d'un empl. de  script  en fr. en 1788 .
score|Empr. à l'angl. score  dont l'orig. est dans l'a. nord.  skor  « entaille, encoche, baguette à encoches, ensemble de vingt, vingtaine » comme l'indique la forme de vieil angl.  scoru  att. tardivement au sens de « vingtaine » . À partir du sens de « entaille, encoche, marque faite pour comptabiliser quelque chose »  le terme a désigné un compte, en partic. le compte des points dans un jeu ou une compétition , l'empl. pour désigner les résultats d'une évaluation chiffrable en psychol. étant att. dep. 1910 . Le  Comité consultatif du lang. sc.  a proposé de remplacer  score  par  cote  . 
scripte|Empr. à l'angl. script girl , syntagme att. en 1928 ds  NED Suppl. , comp. de  girl et de  script  empl. gén. en appos. à un autre terme pour désigner la personne chargée de rédiger et de tenir à jour les notes nécessaires à la réalisation d'un film . La forme officiellement recommandée par l'arrêté du 12 janv. 1973 puis du 24 janv. 1983 est, par francisation,  scripte  .
scrutateur|Empr. au lat. scrutator  « celui qui fouille, qui recherche », de  scrutatum , supin de  scrutari , v.  scruter . Le sens 2 est empr. au lat. médiév.  scrutator  «  id.  » . 
scruter|Empr. au lat. scrutari  « fouiller, explorer, rechercher ». On note déjà l'a. prov.  escrutar  « rechercher » au  xiii <sup e</sup s. . 
scrutin|Empr. au lat. médiév. scrutinium , dans l'expr.  per viam scrutinii  ; du b. lat.  scrutinium  « action de fouiller, examen » , lui-même issu du lat. class.  scrutari , v.  scruter . 
scytale|Empr. au lat. scytala , de mêmes sens, lui-même empr. au gr. σ κ υ τ α ́ λ η «  id.  », propr. « bâton ».
scull|Empr. à l'angl. scull  « aviron dont on peut se servir en ramant successivement d'un côté puis de l'autre »  puis « aviron dont la forme et la longueur permettent l'utilisation en couple par un seul rameur assis au milieu de l'embarcation »  et « embarcation mue au moyen d'un seul ou d'une paire de tels avirons » .
sculpteur|Empr. au lat. de l'époque impériale sculptor  «  id.  », dér. de  sculptum , v.  sculpter . Voir  FEW  t. 11, p. 346b. 
sculpture|Empr. au lat. sculptura  « travail de sculpteur, gravure sur pierre », dér. de  sculptum , supin de  sculpere , v.  sculpter . On note aussi  sculpeure  « art de la sculpture » en m. fr. , dér. de l'anc. verbe  sculper , v.  sculpter . 
scurrile|Empr. au lat. scurrilis  « de bouffon », dér. de  scurra  « bouffon ».
scurrilité|Empr. au lat. scurrilitas  « bouffonnerie », de  scurrilis , v.  scurrile . 
scutellaire|Empr. au lat. sc. scutellaria  , du lat. class.  scutella  « petite coupe », v.  écuelle . 
sebkha|Empr. à l'ar. sabh̆a ,  sabah̆a  « marais; plaine sablonneuse, salée et marécageuse; lac salé » .
second|Empr. au lat. secundus  « qui suit, qui vient après, inférieur, secondaire, favorable », de la racine de  sequi  « suivre ».  Cf.  au sens A 3, l'a. prov.  en secons et au sens B 2 l'a. fr. pr.  segunt  « favorable, profitable » . 
secondaire|Empr. au lat. secundarius  « de second rang », dér. de  secondus  . 
seconde|Empr. au lat. secundus  « qui suit, qui vient après, inférieur, secondaire, favorable », de la racine de  sequi  « suivre ».  Cf.  au sens A 3, l'a. prov.  en secons et au sens B 2 l'a. fr. pr.  segunt  « favorable, profitable » . 
secondine|Empr. au b. lat. méd. secundina  « arrière-faix ». 
secret|Empr. à l'adj. lat. secretus  « spécial; distinct; à l'écart, solitaire, isolé; caché, secret ». Les formes  secré, secrei, -oi; segré, segrei, -oi  représentent des essais d'adapt. au fr. [-g-].  B.  angl.  top-secret , t. milit. d'orig. amér., comp. de l'angl.  top  « du plus haut niveau, le plus important », et  secret , lui-même empr. au fr. . 
section|Empr. au lat. sectio  « action de couper, coupure, amputation », géom. « division à l'infini ». 
secrète|Empr. à l'adj. lat. secretus  « spécial; distinct; à l'écart, solitaire, isolé; caché, secret ». Les formes  secré, secrei, -oi; segré, segrei, -oi  représentent des essais d'adapt. au fr. [-g-].  B.  angl.  top-secret , t. milit. d'orig. amér., comp. de l'angl.  top  « du plus haut niveau, le plus important », et  secret , lui-même empr. au fr. . 
sectateur|Empr. au lat. sectator  « qui accompagne », « sectateur, disciple, tenant d'une doctrine ». 
seephirot|Empr. à l'hébr. postbiblique s <sup  e </sup  phι ̄rōth , plur. de  s <sup  e </sup  phι ̄rā <sup  h </sup « nombre, numération », dér. du verbe  sāphar  « compter ».
sectatrice|Empr. au lat. sectator  « qui accompagne », « sectateur, disciple, tenant d'une doctrine ». 
secte|Empr. au lat. secta  « ligne de conduite, suite, parti, secte, école », de  sequi  « suivre ». 
seephiroth|Empr. à l'hébr. postbiblique s <sup  e </sup  phι ̄rōth , plur. de  s <sup  e </sup  phι ̄rā <sup  h </sup « nombre, numération », dér. du verbe  sāphar  « compter ».
secteur|Empr. au lat. sector  « celui qui tranche », puis « secteur  » . 
sectile|Empr. au lat. sectilis  « coupé; fendu, taillé », « susceptible d'être coupé, sectile ».
sefarade|Empr. à l'hébr. mod. s <sup  e </sup  phāraddι ̄ , plur.  -ι ̄m , « Espagnol; Juif d'Espagne », dér. de l'hébr. biblique  S <sup  e </sup  phārad , n. d'une colonie de Juifs exilés mentionnée ds  Abd. , 20 , ultérieurement identifiée à l'Espagne par la tradition juive.
sefirot|Empr. à l'hébr. postbiblique s <sup  e </sup  phι ̄rōth , plur. de  s <sup  e </sup  phι ̄rā <sup  h </sup « nombre, numération », dér. du verbe  sāphar  « compter ».
sefiroth|Empr. à l'hébr. postbiblique s <sup  e </sup  phι ̄rōth , plur. de  s <sup  e </sup  phι ̄rā <sup  h </sup « nombre, numération », dér. du verbe  sāphar  « compter ».
seime|Empr. à l'angl. seam  « couture; cicatrice; ride, rainure; fissure, gerçure », en partic. comme terme d'hippiatrie: « fissure de la paroi du sabot du cheval » . 
seghia|Empr. à l'ar. maghrébin segia , corresp. à l'ar. class.  sāqiya  « canal d'irrigation » .
segment|Empr. au lat. d'époque impériale segmentum  « coupure, entaille, incision » au fig. « segment, bande », dér. de  secare  « couper ». 
select|Empr. à l'angl. select  « choisi parmi un grand nombre »  d'où, en parlant d'une personne ou d'un ensemble de personnes « de la classe des gens remarquables ou de haut niveau social » , terme empr. au lat.  selectus, -a, -um  part. passé adj. de  seligere  « choisir et mettre à part, trier » et dont on note un empr. aussi en fr. . 
selve|Empr. au port. selva  « forêt » pour désigner la forêt vierge amazonienne;  cf.  l'a. fr.  selve  « forêt » , encore recensé par les dict. jusqu'à  Boiste  1847; du lat.  silva  « forêt ».
semestre|Empr. à l'adj. lat. semestris  « semestriel »; comp. de  sex  « six » et d'un dér. de  mensis  « mois » . 
seneçon|Empr. au lat. senecio  « séneçon », de  senex  « vieillard », sur le modèle du gr. η ̓ ρ ι γ ε ́ ρ ω ν « vieillard du printemps, séneçon », parce que la plante se couvre de poils blancs au printemps.
senior|Empr. à l'angl. senior  « le plus âgé », du lat.  senior  . Voir  NED . 
sempiternel|Empr. au b. lat. sempiternalis  « éternel » , dér. du lat. class.  sempiternus  « qui dure toujours »  et son dér. sempiterneuse  «  très vieille » ), formé de  semper  « toujours » et de  aeternus  « éternel ». 
senor|Empr. à l'esp. señor  « seigneur » , puis titre respectueux placé devant le nom , et à son fém.  señora  « madame »;  señor  est issu du lat.  senior, -oris  . 
senora|Empr. à l'esp. señor  « seigneur » , puis titre respectueux placé devant le nom , et à son fém.  señora  « madame »;  señor  est issu du lat.  senior, -oris  . 
senorita|Empr. à l'esp. señorita  « mademoiselle » , dimin. de  señora  « madame » . 
semoule|Empr. à l'ital. semola  « son » , du lat. tardif  simola  , forme dissimilée du lat. class.  simila  « fleur de farine ». 
sensation|Empr. au lat. tardif sensatio  « fait de comprendre »  dér. du supin du verbe  sentire  « éprouver une sensation ou un sentiment ». 
sensitif|Empr. au lat. médiév. sensitivus  , dér. du lat.  sensus , v.  sens. 
sensitive|Empr. au lat. médiév. sensitivus  , dér. du lat.  sensus , v.  sens. 
sentine|Empr. au lat. class. sentina  « fond de la cale, sentine », au fig. « bas-fond, lie, rebut ». 
sentinelle|Empr. à l'ital. sentinella , att. au sens 1 dep. 1518-25 , dér. de  sentire  « sentir, entendre, écouter » . 
sentence|Empr. au lat. class. sententia  « sentiment, opinion, avis, vote, suffrage, sens, signification, maxime, pensée exprimée », dér. de  sentire  « penser, juger, se rendre compte », v.  sentir . 
sentencieux|Empr. au lat. class. sententiosus  « riche d'idées, de pensées », dér. de  sententia , v.  sentence . 
sensibilité|Empr. au lat. tardif sensibilitas  « sens, signification, sentiment, sensibilité », dér. de  sensibilis,  v.  sensible. 
sentimental|Empr. de l'angl. sentimental  , dér. de  sentiment , de même orig. que le fr.  sentiment *. Voir  Rey - Gagnon Anglic.  1981. 
sentimentale|Empr. de l'angl. sentimental  , dér. de  sentiment , de même orig. que le fr.  sentiment *. Voir  Rey - Gagnon Anglic.  1981. 
sensible|Empr. au lat. impérial sensibilis , au sens passif « ce qui peut être ressenti », puis sens actif « doué de sensibilité », dér. de  sensum , supin de  sentire  . 
sensualité|Empr. au lat. chrét. sensualitas  « faculté de sentir, de percevoir des sensations » . 
sensuel|Empr. au lat. chrét. sensualis  « relatif aux sens; qui tombe sous les sens » . 
sensuelle|Empr. au lat. chrét. sensualis  « relatif aux sens; qui tombe sous les sens » . 
sepharade|Empr. à l'hébr. mod. s <sup  e </sup  phāraddι ̄ , plur.  -ι ̄m , « Espagnol; Juif d'Espagne », dér. de l'hébr. biblique  S <sup  e </sup  phārad , n. d'une colonie de Juifs exilés mentionnée ds  Abd. , 20 , ultérieurement identifiée à l'Espagne par la tradition juive.
septembre|Empr. au lat. september  «  id.  », l'année romaine commençant en mars; dér. de  septem , v.  sept. 
septime|Empr. au lat. septimus , v.  septième ; sur le modèle d'autres termes d'escr.:  prime*, quarte*, tierce* ...
septénaire|Empr. au lat. setpenarius  « composé de sept, septénaire  » et comme subst. « vers septénaire »; dér. de  septem , v.  sept. 
septennal|Empr. au lat. médiév. septennalis  ; de  septem  « sept » et  annus  « an ». Le sens 2 corresp. à l'angl.  septennial act , acte de 1716 qui stipule pour les Parlements une durée de sept ans et pas plus . 
septique|Empr. au lat. septicus  « qui putréfie », du gr. σ η π τ ι κ ο ́ ς « qui engendre la putréfaction », dér. de σ η π ε ι ̃ « corrompre, pourrir ». Au sens 2 empr. à l'angl.  septic tank  «  id.  » . 
septentrion|Empr. au lat. septentrio , sing. tiré du plur.  septemtriones , les sept étoiles de la Grande ou Petite Ourse à laquelle appartient l'étoile polaire; littéral. « les sept bœufs de labour », de  septem  « sept » et  triones  « bœufs de labour ». Voir  FEW  t. 11, p. 481b. 
septentrional|Empr. au lat. septentrionalis  «  id.  », dér. de  septentrio , v.  septentrion . 
septuagénaire|Empr. au lat. septuagenarius  « âgé de soixante-dix ans », dér. de  septuageni  « soixante-dix chacun », lui-même dér. de  septem , v.  sept . 
septentrionale|Empr. au lat. septentrionalis  «  id.  », dér. de  septentrio , v.  septentrion . 
septuagésime|Empr. au lat. chrét. septuagesima  «  id.  », fém. subst. de l'adj. du lat. class.  septuagesimus  « soixante-dixième », de  septuaginta , v.  septante .
septum|Empr. au lat. saeptum, septum  « clôture, barrière, enceinte; diaphragme ». 
sequoia|Empr. au lat. bot. sequoia  «  id.  » 1847  du n. de l'Indien Cherokee  Sequoya  connu pour avoir inventé en 1822 un alph. syllabique pour écrire sa lang., v. aussi  Lang. Monde , p. 1008. 
sérail|Empr. à l'ital. serraglio  , empr. au turc  seraj , persan  särāj  . 
série|Empr. au lat. series  « file, enchaînement, suite ininterrompue  » . 
sérénade|Empr. à l'ital. serenata , att. au sens A 1 dep. la 2<sup e</sup moit. du  xv <sup e</sup s. , ext. de sens de  serenata  « nuit sereine, temps serein », dér. de  sereno  . Voir  FEW  t. 11, p. 510. 
sérieuse|Empr. au lat. médiév. seriosus  « sérieux » , dér. du class.  serius  «  id. », subst. sous la forme neutre  serium  « chose sérieuse ». 
sérapeum|Empr. au b. lat. Serapeum, Serapium, -ii  «  id.  » déb.  iii <sup e</sup s. ds  Gaff. , du gr. Σ ε ρ α π ε ι ̃ ο ν, Σ α ρ α ́ π ι ο ν, Σ α ρ α π ε ι ̃ ο ν, formes contractées de Σ α ρ α π ι ε ι ̃ ο ν «  id.  » dér. de Σ α ́ ρ α π ι ς, Σ ε ́ ρ α π ι ς  nom d'une divinité égyptienne adoptée dans le monde gréco-romain. 
serapeum|Empr. au b. lat. Serapeum, Serapium, -ii  «  id.  » déb.  iii <sup e</sup s. ds  Gaff. , du gr. Σ ε ρ α π ε ι ̃ ο ν, Σ α ρ α ́ π ι ο ν, Σ α ρ α π ε ι ̃ ο ν, formes contractées de Σ α ρ α π ι ε ι ̃ ο ν «  id.  » dér. de Σ α ́ ρ α π ι ς, Σ ε ́ ρ α π ι ς  nom d'une divinité égyptienne adoptée dans le monde gréco-romain. 
sérénité|Empr. au lat. serenitas  « sérénité  », « calme  » et à basse époque « sérénité  », dér. de  serenus  . 
serial|Empr. à l'angl. serial  att. comme subst. désignant une œuvre publiée sous forme de feuilleton dep. 1846 ds  NED  puis des œuvres cin., radiophoniques ou télévisées , empl. subst. de l'adj.  serial  corresp. à l'adj. fr.  sérial  .
sérieux|Empr. au lat. médiév. seriosus  « sérieux » , dér. du class.  serius  «  id. », subst. sous la forme neutre  serium  « chose sérieuse ». 
serapéum|Empr. au b. lat. Serapeum, Serapium, -ii  «  id.  » déb.  iii <sup e</sup s. ds  Gaff. , du gr. Σ ε ρ α π ε ι ̃ ο ν, Σ α ρ α ́ π ι ο ν, Σ α ρ α π ε ι ̃ ο ν, formes contractées de Σ α ρ α π ι ε ι ̃ ο ν «  id.  » dér. de Σ α ́ ρ α π ι ς, Σ ε ́ ρ α π ι ς  nom d'une divinité égyptienne adoptée dans le monde gréco-romain. 
sérial|Empr. à l'angl. serial  att. comme subst. désignant une œuvre publiée sous forme de feuilleton dep. 1846 ds  NED  puis des œuvres cin., radiophoniques ou télévisées , empl. subst. de l'adj.  serial  corresp. à l'adj. fr.  sérial  .
sérapéum|Empr. au b. lat. Serapeum, Serapium, -ii  «  id.  » déb.  iii <sup e</sup s. ds  Gaff. , du gr. Σ ε ρ α π ε ι ̃ ο ν, Σ α ρ α ́ π ι ο ν, Σ α ρ α π ε ι ̃ ο ν, formes contractées de Σ α ρ α π ι ε ι ̃ ο ν «  id.  » dér. de Σ α ́ ρ α π ι ς, Σ ε ́ ρ α π ι ς  nom d'une divinité égyptienne adoptée dans le monde gréco-romain. 
séraphin|Empr. au lat. chrét. Seraphim  « Séraphins » , gr. Σ ε ρ α φ ι ́ μ, empr. à l'hébr. biblique  ś <sup  207 </sup  rāphι ̄m  « Séraphins », plur. de * śārāph , littéral. « brûlant », dér. de * śāraph  « brûler » . 
séraphique|Empr. au lat. médiév. seraphicus , dér. de  Seraphim  « séraphins ». 
séraskier|Empr. au turc serasker  « général d'armée », lui-même empr. au persan  sar-i- askar  « chef de l'armée », comp. du persan  sar  « tête, chef » et de l'ar.  askar  « armée » .  Cf. cadilesquier ,  s.v. cadi  et  lascar .
sérasquier|Empr. au turc serasker  « général d'armée », lui-même empr. au persan  sar-i- askar  « chef de l'armée », comp. du persan  sar  « tête, chef » et de l'ar.  askar  « armée » .  Cf. cadilesquier ,  s.v. cadi  et  lascar .
seringa|Empr. au lat. des botanistes syringa  , du lat.  syringa  « seringue »  n. donné à cet arbrisseau parce que son bois, vidé de la moelle, est utilisé par les enfants comme flûte ou seringue. 
serdab|Empr. à l'ar. oriental sirdāb  « cave, chambre souterraine où l'on se met à l'abri de la chaleur ; chemin souterrain » , lui-même empr. au persan  serdābeh  « habitation d'été souterraine » .
serdar|Empr. au turc serdar  « général en chef », et celui-ci au persan  sardār  « chef, commandant »  . Au sens 2, empr. à l'angl.  sirdar , de même orig., attest. dans ce sens en 1898 .
seringueiro|Empr. au port. du Brésil seringueiro  « ouvrier agricole affecté à la récolte du caoutchouc par saignée des hévéas », dér. de  seringa  « seringue »  qui prit au Brésil le sens de « caoutchouc » .
seringuero|Empr. au port. du Brésil seringueiro  « ouvrier agricole affecté à la récolte du caoutchouc par saignée des hévéas », dér. de  seringa  « seringue »  qui prit au Brésil le sens de « caoutchouc » .
seroual|Empr. à l'ar. maghrébin sərwal  « pantalon très large », corresp. à l'ar. class.  sirwāl , empr. au persan  s̆alvār , même sens Vêt. , 1845, pp. 203-209;  Lok. , n <sup o</sup 1849;  FEW  t. 19, p. 160 et t. 20, pp. 109-110;  Baldinger Etymol.  1, n <sup o</sup 1839;  Frisk  t. 3, p. 176;  Vasmer  t. 3, p. 377;  NED ,  s.v. sherryvalies ;  TLF ,  s.v. charivari <sup 2</sup ).
séroual|Empr. à l'ar. maghrébin sərwal  « pantalon très large », corresp. à l'ar. class.  sirwāl , empr. au persan  s̆alvār , même sens Vêt. , 1845, pp. 203-209;  Lok. , n <sup o</sup 1849;  FEW  t. 19, p. 160 et t. 20, pp. 109-110;  Baldinger Etymol.  1, n <sup o</sup 1839;  Frisk  t. 3, p. 176;  Vasmer  t. 3, p. 377;  NED ,  s.v. sherryvalies ;  TLF ,  s.v. charivari <sup 2</sup ).
serpentaire|Empr. au b. lat. serpentaria  « sorte d'arum », dér. p. anal. de forme du lat.  serpens  .
serpentin|Empr. au lat. serpentinus  « de serpent ». 
serpentine|Empr. au lat. serpentinus  « de serpent ». 
serpule|Empr. au lat. sc. serpula  «  id.  » .
serrate|Empr. au lat. serratus  « en forme de scie; dentelé » ;  cf.  le subst. masc. plur.  serrati , s.-ent.  nummi  « les écus dentelés ».
serratule|Empr. au lat. serratula  « bétoine » , dér. de  serra  « scie », cette plante ayant des feuilles en dents de scie.
service|Empr. au lat. servitium, -ii  « servitude, esclavage, condition d'esclave » et collectiv. « les esclaves », lat. eccl. « service de Dieu, dévotion » dep. 1<sup er</sup tiers  v <sup e</sup s. ds  Blaise Lat. chrét.  et « charge, office » dep.  vi <sup e</sup s.,  ibid. , et en lat. médiév. « service vassalique » dep.  ca  720 ds  Nierm. , « service aulique » dep.  vi <sup e</sup s.,  ibid. , « service de l'ost » dep. 781,  ibid. , « culte » dep. 794,  ibid. , « ensemble des officiers publics » dep. 1114,  ibid. , « service à table, repas servis », 1336 ds  Latham , « service volontaire »,  ca  1080,  ibid. , les autres sens étant en relation avec  servir* . Jusqu'à la fin du  xiii <sup e</sup s. aussi sous la forme  servise . 
sévissant|Empr. au lat. saevire  « être furieux, être en rage », dér. de  saevus  « en fureur, cruel, sauvage », d'où le sens de « commettre des cruautés ». 
servile|Empr. au lat. servilis  «  id.  » au propre et au fig.; − dér. de  servus  « esclave » −, att. en lat. médiév. au sens de « propre aux non-libres » 789 ds  Nierm. , « relatif à un tenancier serf » 828,  ibid.  et comme subst. « tenancier d'un manse servile » 905-906,  ibid. 
sétim|Empr. au lat. setim et celui-ci à l'hébr.  shiṭṭ ι ̄m , plur. de  shiṭṭā <sup  h </sup « acacia », prob. d'orig. égyptienne.
sésame|Empr. au lat. sesamum, sisamum , et celui-ci au gr. σ η ́ σ α μ ο ν « sésame », mot d'orig. sémit. . Voir E.  Masson ,  Rech. sur les plus anc. empr. sémit. en gr. , Paris, 1967, p. 57. 
séton|Empr. au lat. méd. médiév. seto, -onis , latinisation de l'a. prov.  sedon , att. au sens 1 à la fin du  xii <sup e</sup s. , dér. de  seda  « crin, poil d'animal » . 
sésamoïde|Empr. au gr. σ η σ α μ ο ε ι δ η ́ ς « qui ressemble au sésame, à la graine de sésame » , empl. en anat. σ η σ α μ ο ε ι δ η ̃ ο ̓ σ τ α ̃ « os sésamoïdes »  et en bot., n. de deux plantes qui ressemblent au sésame, d'où le lat.  sesamoides  « peut-être le réséda raiponce et le réséda blanc; fruit de l'ellébore noir » . Au sens 2,  cf.  l'a. fr.  sisamin  . 
setter|Empr. à l'angl. setter  att. dep. 1576 comme terme désignant une sorte d'épagneul  et dér. de  to set  au sens de « tomber en arrêt ». 
servite|Empr. au lat. médiév. eccl. servitae , de  servus Beate Marie  « Servite » 1267 ds  Latham , ordre, créé en 1233 par des marchands florentins, professant une dévotion particulière pour la Vierge, et institué pour la première fois dans le diocèse de Marseille en 1257 .
sesbania|Empr. à l'ar. saysabān  et celui-ci au persan  sι ̄sabān , même sens .  Cf.  lat. sc.  sesbanus  ,  sesban  ,  sesbania  .
settler|Empr. à l'angl. settler  « celui qui s'installe dans un nouveau pays, colon » , dér. de  to settle  à l'empl. intrans. « s'établir, se fixer  ».
sesquialtère|Empr. au lat. sesquialter , en parlant d'un nombre « qui en contient un autre une fois et demie », comp. de  sesqui , adv. empl. surtout en compos. « un demi en plus », dér. de  semis , propr. « moitié de l'unité, de l'as » et de  alter  « l'un des deux, l'un, l'autre ». 
serviteur|Empr. au b. lat. des inscriptions servitor, -oris  « serviteur de Dieu », « fidèle serviteur d'un saint; desservant d'une église », et « servant  »  ca  530 ds  Blaise Lat. chrét. , formé sur le supin  servitum  de  servire , v.  servir . 
servitude|Empr. au b. lat. servitudo-, -idinis  « servitude, esclavage » déb.  v <sup e</sup s. ds  Blaise Lat. chrét. , dér. de  servus  « serf », pour servir de subst. abstr. à  servir *, moins fréq. que le class.  servitus, -tutis  « condition d'esclave », fig. « état de dépendance », « assujettissement de terres, d'immeubles », d'où une forme  servitute , fin  xiii <sup e</sup s. [ms.] , servituit fin  xii <sup e</sup s. ;  cf.  aussi la forme  servitune, servitume  1176-81 . 
sexagénaire|Empr. au lat. d'époque impériale sexagenarius  «  id.  », dér. de  sexageni  « chacun soixante », lui-même dér. de  sexaginta  « soixante ». 
sessile|Empr. au lat. d'époque impériale sessilis  « sur quoi l'on peut s'asseoir », « à large base », également terme de bot. formé sur le supin  sessum , de  sedere  « s'asseoir ».
session|Empr. au lat. class. sessio  , « action de s'asseoir; audience d'un prêteur; pause, halte »; le sens 3 est empr. à l'angl.  session , att. en 1553 en ce sens , lui-même empr. en 1386, soit à l'a. fr.  session , soit directement au lat.  sessio  « séance », car le fr. disait en ce sens  séance , mot prôné par  Miege  et  Fér.  mais qui fut détrôné à la Révolution . 
sexagésime|Empr. au lat. eccl. sexagesima  , fém. subst. du lat. class.  sexagesimus  « soixantième », dér. de  sexaginta  « soixante ».
sesterce|Empr. au lat. class. sestertius  «  id.  », comp. de  semis  « moitié de l'as » et de  tertius  « troisième ». 
sexe|Empr. au lat. sexus  « sexe, ensemble des caractères physiques permettant de distinguer le mâle et la femelle ;  p. méton. , ensemble des individus de l'un ou l'autre sexe; organes génitaux ». Au sens A 1 ;  cf.  le lat. médiév.  sexus naturae et  FEW  t. 11, p. 560b, note 1. 
set|Empr. à l'angl. set  att. dep. le  xiv <sup e</sup s. et qui représente à la fois le déverbal de  to set  « établir, disposer » issu du vieil angl. et un empr. à l'a. fr.  sete  « groupe de personnes de même croyance » . À partir de ce dernier sens  le terme a désigné un ensemble de choses, une collection d'objets, en partic. l'ensemble des pièces d'un mobilier coordonné, d'un service de table, etc. , un ensemble de personnes de mêmes intérêts ou même centre d'intérêt, un clan, une coterie ; à partir du sens « mise en place , fait de disposer, d'établir » a désigné ce qui constitue une unité de jeu au jeu de paume ou au tennis , le décor d'une scène de théâtre , d'où un plateau de cin. , et l'empl. en psychol. , v.  NED  et  NED Suppl. <sup 2</sup . 
sexé|Empr. au lat. sexus  « sexe, ensemble des caractères physiques permettant de distinguer le mâle et la femelle ;  p. méton. , ensemble des individus de l'un ou l'autre sexe; organes génitaux ». Au sens A 1 ;  cf.  le lat. médiév.  sexus naturae et  FEW  t. 11, p. 560b, note 1. 
sévices|Empr. au lat. d'époque impériale seavitia  « fureur, violence, furie; rigueur, cruauté », dér. de  saevus  « en fureur; cruel, sauvage ». 
sévir|Empr. au lat. saevire  « être furieux, être en rage », dér. de  saevus  « en fureur, cruel, sauvage », d'où le sens de « commettre des cruautés ». 
shampoing|Empr. à l'angl. shampooing , subst. verbal de  to shampoo  « soumettre à un massage, frictionner » prob. d'orig. hindi , d'où en partic. « frictionner le cuir chevelu avec un produit lavant, laver la tête » , la forme angl.  shampooing  étant essentiellement att. au sens de « massage, friction », à côté de  shampoo , subst. « massage, friction, lavage du cuir chevelu » et « lotion pour laver le cuir chevelu ».
sextant|Empr. au lat. class. sextans  « sixième partie d'une unité »; en partic. « le sixième du nombre parfait : l'unité  », dér. de  sex  « six ». Au sens 3, empr. au lat. sc.  sextans  . 
sexte|Empr. au lat. chrét. sexta  « sexte, heure canoniale » , du lat. class.  sexta , p. ell. pour  sexta hora  « sixième heure  », comp. de  sexta , fém. de  sextus  « sixième », et de  hora  « heure ».  Cf. sieste, sixte , et, parmi les noms des heures canoniales:  prime, tierce, none. 
sextet|Empr. à l'angl. sextet, sextett  « groupe de six musiciens »  d'abord « pièce musicale pour six instruments »  et « strophe de six vers » , puis « groupe, ensemble de six personnes ou choses ». Ce terme représente une relatinisation, peut-être sous l'infl. de l'all.  Sextet , de l'angl.  sestet, sestett empr. lui-même à l'ital.  sestetto  « sextuor », dér. de  sesto  « six ». 
shampooing|Empr. à l'angl. shampooing , subst. verbal de  to shampoo  « soumettre à un massage, frictionner » prob. d'orig. hindi , d'où en partic. « frictionner le cuir chevelu avec un produit lavant, laver la tête » , la forme angl.  shampooing  étant essentiellement att. au sens de « massage, friction », à côté de  shampoo , subst. « massage, friction, lavage du cuir chevelu » et « lotion pour laver le cuir chevelu ».
sextette|Empr. à l'angl. sextet, sextett  « groupe de six musiciens »  d'abord « pièce musicale pour six instruments »  et « strophe de six vers » , puis « groupe, ensemble de six personnes ou choses ». Ce terme représente une relatinisation, peut-être sous l'infl. de l'all.  Sextet , de l'angl.  sestet, sestett empr. lui-même à l'ital.  sestetto  « sextuor », dér. de  sesto  « six ». 
shabbat|Empr. au lat. chrét. sabbatum , lui-même empr. au gr. σ α ́ β β α τ ο ν et celui-ci à l'hébr.  shābbath  « sabbat », dér. du verbe  shābath  « s'arrêter; se reposer » . Au sens 3,  cf.  le lat. médiév.  sabbatum  . On a également employé, pour désigner les assemblées de sorciers et de sorcières, le mot  synagogue  , en lat.  synagoga  . En ce qui concerne la dégradation sém. qu'ont subie les mots  sabbat  et  synagogue, cf. brouhaha ,  ramadan, ramdam. 
shabbatique|Empr. au lat. chrét. sabbaticus  « sabbatique »  et celui-ci au gr. σ α β β α τ ι κ ο ́ ς « qui concerne le sabbat, sabbatique », dér. de σ α ́ β β α τ ο ν . L'expr.  an sabbatique  est la trad. de l'hébr. biblique  sěnat šabbātōn  « année de repos, de cessation » . Au sens 1 b, trad. de l'angl. amér.  sabbatical year  ,  sabbatical leave  . 
sextil|Empr. au lat. médiév. sextilis  ds  aspectus sextilis  « aspect sextil » ; dér. du lat.  sextus  « sixième », suff.  -ilis. Cf. octil, quartile, quintil. 
shah|Empr. au persan šāh  « roi » ;  cf. échec ,  padischah . 
sextile|Empr. au lat. médiév. sextilis  ds  aspectus sextilis  « aspect sextil » ; dér. du lat.  sextus  « sixième », suff.  -ilis. Cf. octil, quartile, quintil. 
sexy|Empr. à l'angl. sexy , dér. de  sex  , att. seulement dep. 1928 ds  NED Suppl. <sup 2</sup 
shaker|Empr. à l'angl. shaker , dér. de  to shake  « secouer, agiter, trembler, branler », att. dep.  ca  1440 et plus partic. dep. le  xvii <sup e</sup s. pour désigner les membres de sectes telles que celles des  quakers*  . 
shed|Empr. à l'angl. shed  « construction légère destinée à abriter quelque chose, toit de hangar, hangar » att. dep. 1481 et qui représente prob. une var. de  shade  « ombre, ce qui donne de l'ombre, protection » issu du vieil angl.  sceadu, scead  . 
sextine|Empr. à l'ital. sestina  , dér. de  sesto  « sixième ». 
shako|Empr. au hongr. csákó , de même sens. Cette coiffure fut importée en France au cours du  xviii <sup e</sup s. par les Hongrois qui servirent notre pays sous le nom de  hussards.  Au début du  xix <sup e</sup s. le port de  shako  se répandit dans la plupart des corps de l'armée . 
sherry|Empr. à l'angl. sherry  , forme altérée de Xeres  selon un type  sherris  réduit à  sherry  par suppression de  s  final pris pour marque du plur. 
sextuple|Empr. au b. lat. sextuplex, sextuplus même sens, comp. de  sextu- et de l'élém.  -plex  ou son doublet  -plus  figurant comme second terme de comp. dans des adj. multiplicatifs . 
shetland|Empr. au nom d'un groupe d'îles du nord-est de l'Écosse utilisé pour désigner une race de moutons originaire de cette région  et la laine ou les produits fabriqués avec la laine de ces moutons ainsi qu'une race de poneys . 
shibolet|Empr. à l'hébr. biblique shibbōlet  « épi », mot utilisé par les gens de Galaad pour reconnaître ceux d'Ephraïm, qui prononçaient  sibbōlet , et qu'ils égorgeaient aussitôt .
short|Empr. à l'angl. shorts , subst., de l'adj.  short  « court » utilisé au plur. pour désigner des culottes courtes  et att. au sing. au même sens en anglo-amér. 
shiboleth|Empr. à l'hébr. biblique shibbōlet  « épi », mot utilisé par les gens de Galaad pour reconnaître ceux d'Ephraïm, qui prononçaient  sibbōlet , et qu'ils égorgeaient aussitôt .
show|Empr. à l'angl. show  « mise en vue » subst. du verbe  to show  « montrer » att. dep. le déb.  xiv <sup e</sup s., plus spéc. aux sens de « spectacle monté et organisé pour divertir un public »  et « présentation, spectacle de raretés, de curiosités »  « exposition, présentation publique  » . 
shilling|Empr. à l'angl. shilling , terme issu du vieil angl. et d'orig. obsc., désignant une monnaie évaluée à un vingtième de la livre depuis la conquête normande . 
shimmy|Empr. à l'anglo-amér. shimmy , altér. du fr.  chemise désignant une danse au cours de laquelle les mouvements du corps se transmettent à la chemise en la faisant trembler . 
sicaire|Empr. au lat. sicarius  «  id.  » . 
shunt|Empr. à l'angl. shunt  , déverbal de  to shunt  « s'écarter, se détourner »  d'où « éviter, détourner »  et spéc.  « détourner de la voie principale, faire passer sur une voie secondaire, garer »  d'orig. inconnue.
shipchandler|Empr. à l'angl. ship-chandler  « commerçant qui fournit les bateaux »  comp. de  chandler  « marchand de chandelles » d'où « commerçant, fournisseur » empr. en a. fr. à  chandelier <sup 1</sup * et de  ship  « bateau » issu du vieil anglais.
siccatif|Empr. au b. lat. siccativus  « dessicatif », dér. de  siccatum , v.  siccateur .
shirting|Empr. à l'angl. shirting  « tissu propre à faire des chemises » , dér. de  shirt  « chemise » à l'aide du suff.  -ing. 
shunter|Empr. à l'angl. to shunt att. comme terme d'électr. dep. 1873 .
shocking|Empr. à l'angl. shocking  « qui offense, qui choque »  part. prés. adj. de  to shock  prob. issu du fr.  choquer *. 
siccité|Empr. au lat. siccitas « sécheresse, état de sécheresse ».
sicilien|Empr. au lat. médiév. sicilianus  « sicilien » , lat. class.  siciliensis , dér. de  Sicilia , n. lat. de la Sicile. 
sicilienne|Empr. au lat. médiév. sicilianus  « sicilien » , lat. class.  siciliensis , dér. de  Sicilia , n. lat. de la Sicile. 
sicle|Empr. au lat. de la Vulgate siclus , et celui-ci à l'hébr. biblique  sheqel  « sicle  »  »); dér. de  shāqal  « peser ». Au sens 2,  sicle  est un autre nom de  denier  qui est l'un des quatre emblèmes des cartes de points, avec le  bâton , la  coupe  et l' épée  .
sicule|Empr. au lat. siculus  « sicilien ».
shooter|Empr. à l'angl. to shoot  issu du vieil angl.  scéotan  « se précipiter, s'élancer, passer d'un trait, d'un coup vif » et « précipiter, lancer, décocher » d'où, en sport « tirer au but »  et att. en anglo-amér. dans la langue des toxicomanes . 
sibiler|Empr. au lat. sibilare  « siffler; produire un sifflement » , v. aussi  siffler .
shopping|Empr. à l'angl. shopping  « fait d'aller dans les magasins » , dér. de  shop  « magasin, boutique », issu du vieil angl. et apparenté au m. néerl. qui est à l'orig. de  échoppe <sup 1</sup *; le verbe  to shop  att. auparavant au sens de « mettre en vente, exposer dans une boutique » peut être considéré comme la base de cette dér. dans la mesure où la forme  shopping  lui attribue le sens de « visiter des boutiques pour y faire éventuellement des achats ». 
sibyllin|Empr. au lat. sibyllinus  de même sens ; le recueil des livres sibyllins était déposé à Rome, depuis Tarquin l'Ancien, au Capitole, sous la garde d'un collège de prêtres . 
sidi|Empr. à l'ar. maghrébin sι ̄dι ̄ « mon seigneur », dér., au moyen du suff. poss. de la 1<sup re</sup pers. du sing.  -ι ̄ , de  sι ̄d , en ar. class.  sayyid  « chef, seigneur, maître; monsieur; titre des descendants directs de Mahomet ». Au Maghreb,  sι ̄dι ̄ est également empl. comme titre d'honneur devant les n. des saints de l'Islam. 
