zaouia|Empr. à l'ar. zāwiya  « angle, coin, cellule; petite mosquée, oratoire »; spéc., au Maghreb « petite mosquée recouverte d'un dôme, construite sur le tombeau d'un saint de l'Islam, et comprenant des locaux pour la lecture du Coran, la prière, l'enseignement religieux et général, l'hébergement des maîtres, des étudiants, des voyageurs, des mendiants » .
zée|Empr. au lat. zaeus, zeus  , désignant une espèce de poisson .
zéolite|Empr. au lat. sc. zeolithus  «  id.  », formé du gr. ζ ε ́ ω « je bous » et λ ι ́ θ ο ς « pierre ».
zaouïa|Empr. à l'ar. zāwiya  « angle, coin, cellule; petite mosquée, oratoire »; spéc., au Maghreb « petite mosquée recouverte d'un dôme, construite sur le tombeau d'un saint de l'Islam, et comprenant des locaux pour la lecture du Coran, la prière, l'enseignement religieux et général, l'hébergement des maîtres, des étudiants, des voyageurs, des mendiants » .
zéolithe|Empr. au lat. sc. zeolithus  «  id.  », formé du gr. ζ ε ́ ω « je bous » et λ ι ́ θ ο ς « pierre ».
zapper|Empr. à l'angl. to zap, zapp , terme arg. d'orig. nord-amér. att. dep. 1942, prob. dér. de l'onomat.  zap  suggérant le bruit de certaines armes, et signifiant « éliminer, tuer » d'où « annuler, changer » et « faire une action ou un mouvement brusque, rapide » d'où « sauter les annonces publicitaires en accélérant la lecture sur un magnétoscope » et « passer rapidement d'une chaîne de télévision à une autre » .
zabre|Empr. au lat. des zoologistes zabrus  «  id.  » d'orig. obscure. 
zélateur|Empr. au lat. chrét. zelator  « jaloux, envieux; vengeur empressé » , dér. de  zelare , v.  zelanti . 
zaptié|Empr. au turc zaptiye  « gendarmerie; gendarme » et celui-ci à l'ar.  ḍābiṭīya <sup  h </sup , plur. de  ḍābiṭī « agent de police »;  ḍābiṭīya <sup  h </sup ,  ḍabṭīya <sup  h </sup « police ». 
zélatrice|Empr. au lat. chrét. zelator  « jaloux, envieux; vengeur empressé » , dér. de  zelare , v.  zelanti . 
zéphir|Empr. au lat. zephyrus  « vent d'ouest doux et tiède; dieu qui le personnifie », gr. ζ ε ́ φ υ ρ ο ς « vent du nord-ouest généralement violent ou pluvieux; dieu qui le personnifie ». 
zaptyé|Empr. au turc zaptiye  « gendarmerie; gendarme » et celui-ci à l'ar.  ḍābiṭīya <sup  h </sup , plur. de  ḍābiṭī « agent de police »;  ḍābiṭīya <sup  h </sup ,  ḍabṭīya <sup  h </sup « police ». 
zèle|Empr. au lat. zelus  « esprit d'émulation, jalousie » empl. par les aut. chrét. pour désigner la colère divine, la ferveur, le zèle vengeur et fanatique , du gr. ζ η ̃ λ ο ς « jalousie, ferveur ». 
zéphire|Empr. au lat. zephyrus  « vent d'ouest doux et tiède; dieu qui le personnifie », gr. ζ ε ́ φ υ ρ ο ς « vent du nord-ouest généralement violent ou pluvieux; dieu qui le personnifie ». 
zain|Empr. à l'ital. zaino  « qui n'a aucun poil blanc  », att. dep. 1573 , lui-même empr., malgré l'écart chronol., à l'esp.  zaino  «  id.  » et « traître, faux  », att. dep. 1604 , d'orig. ar. mais d'étymon incertain . 
zarf|Empr. au turc zarf , même sens, et celui-ci à l'ar.  ẓarf  « petit gobelet en argent ou en cuivre, en forme de coquetier, dans lequel on pose la tasse » . 
zellige|Empr. à l'ar. maghrébin zulaiǧ ,  zullaiǧ « carreaux de faïence colorés et vernis » , qui est lui-même soit empr. à l'esp.  azulejo , même sens, dér. de  azul  « bleu » , soit dér. de l'ar.  zuluǧ « pierres lisses » .
zélote|Empr. au lat. chrét. zelotes  « zélé; du parti des zélés », transcrivant le gr. ζ η λ ω τ η ́ ς « admirateur zélé », usité comme épit. pour Simon le Cananéen .
zéphyr|Empr. au lat. zephyrus  « vent d'ouest doux et tiède; dieu qui le personnifie », gr. ζ ε ́ φ υ ρ ο ς « vent du nord-ouest généralement violent ou pluvieux; dieu qui le personnifie ». 
zèbre|Empr. au port. zebra , att. au sens 1 dep. le  xvi <sup e</sup s. , d'abord « âne sauvage, onagre » territorio Ezebreiro ,  Ezebrario  dans des topon. att. ds des doc. des  x <sup e</sup et  xi <sup e</sup s., v. J.  da Silveira , prob. issu, comme l'esp.  cebra  , d'un lat. vulg. * eciferus , du lat.  equiferus  « cheval sauvage », comp. de  equus  « cheval » et  ferus  « sauvage ». Les Portugais ont appliqué le nom d'une espèce d'âne sauvage abondamment répandue dans la Péninsule ibérique jusqu'au  xvi <sup e</sup s., au zèbre, animal sauvage qu'ils découvraient en Afrique à cette époque. Voir J.  da Silveira  ds  R. port. Filol.  t. 2, pp. 220-247; K.  Baldinger  ds  Z. rom. Philol.  t. 71, pp. 314-318;  Arv. , pp. 502-514;  Cor. -Pasc. 
zéro|Empr. à l'ital. zero  « zéro » , « rien » , altér. de  zefiro  , issu du lat. médiév.  zephirum  , empr. à l'ar.  ṣifr  « vide; zéro » . Le m. fr.  zéro  a supplanté  chiffre  dans le sens « zéro » que ce dernier avait en a. fr. et m. fr. avant de se spécialiser, à partir de la fin du  xv <sup e</sup s., dans celui de « signe d'un système numérique », qu'il a toujours. 
zénith|Empr. au lat. médiév. zenit  ,  cenith  ;  zenith  ; ces formes sont issues par mauvaise lecture  de  semt, zemt , transcr. de l'ar.  samt , pour  samt ar-ra's  « zénith  ». V. également  Devic ,  Cor. ,  s.v. cenit ,  FEW  t. 19, p. 153. 
zerumbet|Empr. à l'ar. zarunba <sup  h </sup ,  zarunbād , et celui-ci au persan  zurunbād  .  Cf.  lat. sc.  zurumbet  .
zérumbet|Empr. à l'ar. zarunba <sup  h </sup ,  zarunbād , et celui-ci au persan  zurunbād  .  Cf.  lat. sc.  zurumbet  .
zircon|Empr. à l'all. Zirkon , créé en 1783 par le minéralogiste all. A. G. Werner et repris par M. H. Klaproth en 1789,  cf.  W.  Mettmann ,  Zirkon und Hyazinth  ds  Rom. Forsch.  t. 74 1962, pp. 125-126. La formation de l'all.  Zirkon  reste obsc., v. W.  Mettmann ,  loc. cit. 
ziggourat|Empr. à l'akkadien ziqquratu  « élévation, pinacle; sommet d'une montagne, tour d'un temple », dér. du verbe  zaqaru  « être élevé » .
ziggurat|Empr. à l'akkadien ziqquratu  « élévation, pinacle; sommet d'une montagne, tour d'un temple », dér. du verbe  zaqaru  « être élevé » .
zétète|Empr. au gr. ζ η τ η τ η ́ ς « à Athènes, magistrat chargé de rechercher les débiteurs de l'État et de recouvrer les créances arriérées », dér. de ζ η τ ε ́ ω « chercher à trouver ».
zététique|Empr. au gr. ζ η τ η τ ι κ ο ́ ς « qui est apte à rechercher, à examiner », nom donné aux philosophes sceptiques, η ̔ ζ η τ η τ ι κ η ́ « la doctrine des sceptiques » .
zizanie|Empr. au lat. chrét. zizania  neutre plur. « ivraie, mauvaise herbe »  , lui-même empr. au gr. ζ ι ζ α ́ ν ι ο ν, même sens, lequel à son tour serait empr. à une lang. orientale . Au sens 2,  cf.  lat. chrét.  zizania  neutre plur. et fém. sing. « ivraie, mauvaise herbe, comme symbole de mauvaises influences, jalousie, discorde, hérésie » ; au sens 3, empr. au lat. sc.  zizania  . 
zeugma|Empr. au lat. tardif zeugma , terme de gramm., empr. au gr. ζ ε υ ̃ γ μ α «  id.  », évol. sém. de ζ ε υ ̃ γ μ α « tout ce qui sert à joindre », « joug », « lien », dér. de ζ ε υ ́ γ ν υ μ ι « attacher au joug », « unir, joindre ».
zeugme|Empr. au lat. tardif zeugma , terme de gramm., empr. au gr. ζ ε υ ̃ γ μ α «  id.  », évol. sém. de ζ ε υ ̃ γ μ α « tout ce qui sert à joindre », « joug », « lien », dér. de ζ ε υ ́ γ ν υ μ ι « attacher au joug », « unir, joindre ».
zinjanthrope|Empr. au lat. sc. mod. zinjanthropus , mot créé par L. B. S. Leakey  à partir de  Zing , ancien nom de l'Est de l'Afrique et du gr. α ́ ν θ ρ ω π ο ς « homme ».
zinnia|Empr. au lat. sc. zinnia  , mot créé à partir du nom du botaniste all.  Zinn  [1727-1759], qui fut directeur du jardin botanique de l'université de Göttingen. 
zinc|Empr. à l'all. Zink , au sens 1. 
zinzolin|Empr. à l'ital. giuggiolena  « sésame » , parce qu'à partir de la graine de cette plante on obtient une teinture violette, lui-même empr. à l'ar.  ǧulǧulān  « sésame »; la nasalisation de la forme 2 est mal expliquée . 
zob|Empr. à l'ar. maghrébin zob, zeb  « membre viril » , et, avec le suff. poss. de la 1<sup re</sup pers. du sing.  -ī :  zobbī ,  zebbī . L'ar.  zeb  est att. ds une phrase citée par  Flaub. ,  Corresp. , 1859, p. 327: Taïeb!  Zeb  Ketir!
zicrone|Empr. au lat. sc. mod. zicrona , créé par C. J. B. Amyot et A. Serville qui le font remonter à un mot hébr.  zicron  signifiant « odorant ». Cet étymon pourrait être mis en rapport avec l'hébr.  sāraḥ « sentir mauvais, puer », et le subst.  sirḥōn  « puanteur, mauvaise odeur ».
zinckénite|Empr. à l'all. Zinckenit , de même sens , dér. du nom de K. J. Zincken, directeur de mines .
zobbi|Empr. à l'ar. maghrébin zob, zeb  « membre viril » , et, avec le suff. poss. de la 1<sup re</sup pers. du sing.  -ī :  zobbī ,  zebbī . L'ar.  zeb  est att. ds une phrase citée par  Flaub. ,  Corresp. , 1859, p. 327: Taïeb!  Zeb  Ketir!
zobi|Empr. à l'ar. maghrébin zob, zeb  « membre viril » , et, avec le suff. poss. de la 1<sup re</sup pers. du sing.  -ī :  zobbī ,  zebbī . L'ar.  zeb  est att. ds une phrase citée par  Flaub. ,  Corresp. , 1859, p. 327: Taïeb!  Zeb  Ketir!
zoom|Empr. à l'angl. zoom  « prise de vue avec réduction rapide du champ jusqu'au gros plan sans perte de netteté » , cette prise étant possible avec un objectif à distance focale variable appelé  zoom lens et, seulement beaucoup plus tard, p. ell. de  lens  « lentille, objectif »,  zoom  . Ce terme est issu du verbe onomat.  to zoom  « bourdonner, vrombir »  d'où, en parlant d'un avion « effectuer une brusque montée en chandelle » et subst. « montée en chandelle » , d'où « effectuer un déplacement rapide » .
zodiaque|Empr. au lat. zodiacus  « cercle contenant les douze signes parcourus par le soleil », empr. au gr. ζ ω δ ι α κ ο ́ ς, dér. de ζ ω ́ δ ι ο ν « figurine d'animal, signe du zodiaque ». 
zone|Empr. au lat. class. zona  « ceinture »  puis à partir de l'époque impériale terme de géogr. . 
zoé|Empr. au lat. des zoologistes zoea , du gr. ζ ω η ́ « la vie, l'existence » dér. de ζ η ̃ ν « vivre ». 
zoïde|Empr. au gr. ζ ω ο ε ι δ η ́ ς « semblable à un animal » comp. de ζ ω ̃ ο ν « être vivant » et de ε ι ̃ δ ο ς « aspect extérieur, forme, apparence ».
zoïle|Empr. au lat. d'époque impériale Zoilus , gr. Ζ ω ́ ι ̈ λ ο ς nom d'un grammairien d'Alexandrie du  iv <sup e</sup s. av. Jésus-Christ, célèbre par son traité en neuf livres où il dénonçait les absurdités et les contradictions d'Homère; a été empl. dès Ovide comme synon. de « détracteur ».
zonule|Empr. au lat. class. zonula  « petite ceinture », dimin. de  zona , v.  zone . Au sens 2, le mot lat.  zonula  a été repris par les scientifiques, puis francisé. 
zonure|Empr. au lat. sc. mod. zonurus  «  id.  » 1820  du gr. ζ ω ́ ν η « ceinture »  et de ο υ ̓ ρ α ́ « queue des animaux ».
zooïde|Empr. au gr. ζ ω ο ε ι δ η ́ ς « semblable à un animal » comp. de ζ ω ̃ ο ν « être vivant » et de ε ι ̃ δ ο ς « aspect extérieur, forme, apparence ».
zoophore|Empr. au lat. zoophorus, zophorus  même sens  et celui-ci au gr. ζ ω ο φ ο ́ ρ ο ς adj. « qui porte des animaux, c'est-à-dire orné de figures d'animaux » subst. « le zodiaque », comp. des élém. ζ ω ο- et -φ ο ρ ο ς . En ital.  zooforo  est att. en 1521 . 
zoophyte|Empr. au gr. ζ ω ο ́ φ υ τ ο ν « zoophyte, intermédiaire entre l'animal et la plante », comp. des élém. ζ ω ο- et -φ υ τ ο ν . 
zygène|Empr. au lat. zygaena  « marteau  » et celui-ci au gr. ζ υ ́ γ α ι ν α, même sens . Au sens 2, du lat. sc.  zygaena  .
zorille|Empr. aux mots hispano-amér. zorrino, -a  et  zorrillo  « mouffette », tous deux dér. de  zorra  « renard » . 
zuchette|Empr. à l'ital. zucchetta  « petite courge » , dér. dimin. de  zucca  « courge », prob. issu avec métathèse de la syll. init., du lat.  cucutia  «  id.  ».  FEW  t. 2, p. 1461a;  DEI .
zostère|Empr. au lat. d'époque impériale zoster  «  id.  »  cette plante est ainsi nommée à cause de ses longues feuilles étroites.
zygoma|Empr. au gr. ζ υ ́ γ ω μ α « arcade zygomatique » , propr. « ce qui sert à relier, à assujettir », dér. de ζ υ γ ο ́ ω « joindre ».
zouave|Empr. à l'ar. maghrébin Zwāwa  « nom d'une confédération de tribus kabyles de la région du Djurdjura, en Algérie, où étaient traditionnellement recrutés des soldats ». 
zygote|Empr. sav. au gr. ζ υ γ ω τ ο ́ ς « attelé », dér. de ζ υ γ ο ́ ω « joindre, atteler ». Au sens 3, empr. à l'all.  Zygote  . 
zymotique|Empr. au gr. ζ υ μ ω τ ι κ ο ́ ς « propre à faire fermenter », dér. de ζ υ μ ω τ ο ́ ς « fermenté », adj. verbal de ζ υ μ ο ́ ω « faire fermenter, faire lever », dér. de ζ υ ́ μ η « levain ».  Cf.  angl.  zymotic  . 
