ukulele|Empr. à l'anglo-amér. ukulele  , du mot hawaïen comp. de  uku  « puce » et  lele  « qui saute », surnom d'un personnage local qui jouait vivement de cet instrument en gesticulant, puis nom de cet instrument lui-même, petite guitare introduite par les Portugais .
ukulelé|Empr. à l'anglo-amér. ukulele  , du mot hawaïen comp. de  uku  « puce » et  lele  « qui saute », surnom d'un personnage local qui jouait vivement de cet instrument en gesticulant, puis nom de cet instrument lui-même, petite guitare introduite par les Portugais .
ulmaire|Empr. au lat. des bot. ulmaria , dér. du lat.  ulmus  « orme », à cause d'une ressemblance entres les feuilles.
ukuléle|Empr. à l'anglo-amér. ukulele  , du mot hawaïen comp. de  uku  « puce » et  lele  « qui saute », surnom d'un personnage local qui jouait vivement de cet instrument en gesticulant, puis nom de cet instrument lui-même, petite guitare introduite par les Portugais .
ukulélé|Empr. à l'anglo-amér. ukulele  , du mot hawaïen comp. de  uku  « puce » et  lele  « qui saute », surnom d'un personnage local qui jouait vivement de cet instrument en gesticulant, puis nom de cet instrument lui-même, petite guitare introduite par les Portugais .
ulotrique|Empr. au gr. ο υ ̓ λ ο ́ θ ρ ι ξ « aux cheveux bouclés, crépus», formé de ο υ ̃ λ ο ς « crépu » et de θ ρ ι ́ ξ « cheveu ».
ulcérant|Empr. au lat. ulcerare  « blesser, faire une plaie »; fig. « blesser le cœur ».
ulcération|Empr. au lat. ulceratio  « ulcération, ulcère »;  cf.  l'a. prov.  ulceratio  . 
ultérieur|Empr. au lat. ulterior  « qui est au-delà, de l'autre côté », formé sur le rad. de  ultra  . 
ulcère|Empr. au lat. ulcus, eris  « ulcère, plaie »; fig. « plaie du cœur, blessure morale ».  Cf.  l'a. prov.  ulcera  . 
ulcéré|Empr. au lat. ulcerare  « blesser, faire une plaie »; fig. « blesser le cœur ».
ulcérer|Empr. au lat. ulcerare  « blesser, faire une plaie »; fig. « blesser le cœur ».
ulcéreuse|Empr. au lat. ulcerosus  « couvert d'ulcères »; fig. « blessé ».
ultimatum|Empr. au lat. des diplomates ultimatum , dér. de  ultimus  , d'apr. le lat.  imperatum  « commandement ». 
ulcéreux|Empr. au lat. ulcerosus  « couvert d'ulcères »; fig. « blessé ».
ultime|Empr. au lat. ultimus  « dernier ».  Ultime  subit une éclipse au déb. du  xvii <sup e</sup s. avant de réapparaître au  xix <sup e</sup s. . 
uê|Empr. au lat. class.  exiguus  « petit, exigu ». 
uléma|Empr. au turc ulema  « savants; les ulémas »  et celui-ci à l'ar.  ulamā' , plur. de  ālim  « savant, docte, érudit », part. actif subst. de  alima  « savoir, connaître ». 
uhlan|Empr. à l'all. Uhlan  de même sens, empr., par l'intermédiaire du polon.  ulan , au turc  oǧlan  « jeune homme » . La forme  ullac  , donnée par le  FEW, loc. cit.  comme un 1<sup er</sup empr. du mot turc, désigne un envoyé, un messager  sept ou huict autres personnes seullement, allant en  ullac  vers ledit Bude``) et elle est plutôt un empr. au turc  ulak , de même sens. 
ukase|Empr. au russe ukaz  « édit, décret », du verbe  ukazat'  « décréter ». 
ulluco|Empr. à un dial. du Pérou ulluco , de même sens. 
ulluque|Empr. à un dial. du Pérou ulluco , de même sens. 
ultramontain|Empr. au lat. médiév. ultramontanus  « qui est au-delà des monts »  formé sur le modèle du lat.  transmontanus  « qui se trouve au-delà des monts », v. aussi  tramontane ;  cf. outremontain  «  id.  » att. de  ca  1300 au  xvi <sup e</sup s. . 
ultramontaine|Empr. au lat. médiév. ultramontanus  « qui est au-delà des monts »  formé sur le modèle du lat.  transmontanus  « qui se trouve au-delà des monts », v. aussi  tramontane ;  cf. outremontain  «  id.  » att. de  ca  1300 au  xvi <sup e</sup s. . 
unanime|Empr. au lat. unanimus  « qui a les mêmes sentiments; qui vit en accord avec » comp. de  unus  « un seul » et  animus  « âme, esprit, cœur ». 
ululant|Empr. au lat. ululare  « hurler  », « vociférer ». 
ululation|Empr. au b. lat. ululatio  « hurlement funèbre ». 
ululer|Empr. au lat. ululare  « hurler  », « vociférer ». 
unanimité|Empr. au lat. unanimitas  « accord, harmonie, concorde » dér. de  unanimus  . 
underground|Empr. à l'angl. underground  « souterrain » comp. de  ground  « sol » et de  under  « sous », prép. fonctionnant comme préf. Att. dep. le  xvi <sup e</sup s., d'abord comme adv. puis comme adj. qualifiant des éléments, des choses ou des phénomènes souterrains,  underground  est att. au fig. dep. la fin du  xvii <sup e</sup s. dans la qualification de qqc. de caché ou de secret, d'où son empl., att. dep. 1939, pour qualifier des groupes ou organisations agissant dans la clandestinité et dep. 1953 pour qualifier ce qui relève d'une culture marginale; de là l'empl. subst. pour désigner un groupe ou un mouvement d'où émane cette culture . Comme subst.,  underground  qui désignait des choses souterraines servit en partic. dans l'appellation du ch. de fer souterrain de Londres .
unifié|Empr. au b. lat. unificare  « unifier, rendre un », déb.  v <sup e</sup s.  - lui-même comp. de  unus , v.  un <sup 1</sup et de  facere , v.  faire  - francisé d'apr. les verbes en  -fier *. 
unifier|Empr. au b. lat. unificare  « unifier, rendre un », déb.  v <sup e</sup s.  - lui-même comp. de  unus , v.  un <sup 1</sup et de  facere , v.  faire  - francisé d'apr. les verbes en  -fier *. 
unicolore|Empr. au lat. unicolor  « qui est d'une seule couleur », comp. de  unus  « un  » et  color  « couleur ».
unicorne|Empr. au lat. unicornis  , « qui n'a qu'une corne », empl. comme subst. en lat. eccl. au sens de « animal fabuleux à une seule corne » . 
uniforme|Empr. au lat. d'époque impériale uniformis  « simple, uniforme », comp. de  unus , v.  un <sup 1</sup et de  forma , v.  forme . 
unique|Empr. au lat. unicus  « seul; incomparable, sans égal », dér. de  unus  « un  ». 
unir|Empr. au lat. d'époque impériale unīre  « unir », dér. de  unus , v.  un <sup 1</sup . 
uniformité|Empr. au b. lat. uniformitas  « uniformité » lui-même dér. du lat. d'époque impériale  uniformis , v.  uniforme <sup 1</sup . 
unifiant|Empr. au b. lat. unificare  « unifier, rendre un », déb.  v <sup e</sup s.  - lui-même comp. de  unus , v.  un <sup 1</sup et de  facere , v.  faire  - francisé d'apr. les verbes en  -fier *. 
union|Empr. au b. lat. unio  « union », dér. de  unus , v.  un <sup 1</sup ; le sens 5 a en partic. concernant les États-Unis est empr. à l'anglo-amér.  Union qui a d'abord désigné un projet d'association de type confédéral des treize colonies , puis cette confédération elle-même, et à partir de 1787 les États-Unis ; le sens 6 b est l'adapt. de l'angl.  trade union  att. en 1831 , formé de  trade  « emploi; corps de métier » et de  union  et qui dès 1833 a le sens de « syndicat » ; actuellement le fr.  union  est réservé aux historiens et aux réalités anglo-sax.,  cf.  6 c,  syndicat  s'est imposé dans l'usage dès le  xix <sup e</sup s. . 
univalve|Empr. au lat. sc. univalvus , comp. de  uni- et  valva  , utilisé par Théodore Gaza  pour traduire le gr. μ ο ν ο ́ θ υ ρ ο ς « qui n'a qu'une valve  » , comp. de μ ο ν ο- - *) et θ υ ́ ρ α « porte; valve  » . En angl.,  univalve  est att. comme adj. en 1661  et  Univalv  comme subst. en 1668. 
upas|Empr. au malais ūpas  « poison » et  pōhn ūpas  « arbre à poison » n  « arbre » et  ūpas ), v.  Lok.  n<sup o</sup 2136,  Devic ,  Dalg . En angl.,  upas  est att. dès 1783 . 
unisson|Empr. au lat. scolast. unisonus  adj. « de son uniforme, monotone »  att. au  vi <sup e</sup s. . 
uppercut|Empr. à l'angl. uppercut comp. de  cut  « coupe, taillade » d'où « coup » et  upper  au sens de « dirigé vers le haut ou le point le plus haut ». 
upsilon|Empr. au gr. υ ̃ ψ ι λ ο ́ ν, nom de la lettre υ, littéral., « u pur, ou simple » . Au sens 3, empr. à l'angl.  upsilon  .
uque|Empr. au lat.  caducus  « , qui tombe, ou est près de sa chute », ; d'où « fragile, périssable », ; terme méd. « qui tombe du fait de l'épilepsie, épileptique », , d'où en b. lat. l'adj. substantivé  caduca « épilepsie », ; terme jur. dep.  Cicéron ,  De orat.,  3, 122,  ibid.,  36, 23.
universalité|Empr. au b. lat. universalitas  « généralité, universalité, l'universel » , lat. scolastique « universalité; ensemble, totalité » ; dér. de  universalis  , suff.  -itas  . 
uraète|Empr. au lat. sc. uroaetus  , formé des élém.  uro- , tiré du gr. ο υ ̓ ρ α ́ « queue »  et  -aetus , tiré du gr. α ̓ ε τ ο ́ ς « aigle » .
universel|Empr. au lat. d'époque impériale universalis  « universel, général », dér. au moyen du suff.  -alis de  universus  . 
unité|Empr. au lat. d'époque impériale unitas  « unité, identité, unité de sentiments », dér. de  unus , v.  un . Le sens IV 1 sans doute calque de l'anglo-amér.  Neighbourghood unit , 1953 , comp. de  neighbourhood  « voisinage » et de  unit  « unité ». 
université|Empr. au lat. class. universitas « universalité, totalité, ensemble; ensemble des choses, univers », b. lat. « corps, compagnie, corporation, communauté », lat. médiév. « toute collectivité religieuse, politique, sociale ou professionnelle  » , puis, par spécialisation d'empl.  universitas magistrorum  « corporation des maîtres  » ;  universitas magistrorum et scolarium  « corporation des maîtres et des étudiants »  et en empl. abs.  universitas  même sens . Aux sens 4 b et c: la première Université populaire a été créée à Paris en 1898 par Georges Deherme et une  Société des Universités populaires  fondée le 12 mars 1898 par G. Séailles, H. Michel et G. Deherme . La première Université du troisième âge a été créée à Toulouse en 1973 par le Professeur P. Vellas . 
uranie|Empr. au lat. sc. urania  , formé prob. sur le gr. ο υ ̓ ρ α ́ ν ι ο ς « céleste; merveilleux, prodigieux, très grand ». 
unitif|Empr. au lat. médiév. unitivus  « qui unit » att. au  ix <sup e</sup s. dans le domaine angl. ,  cf.  aussi l'adv.  unitive , terme de scolast. « en union, de manière à unir » ; dér. de  unire , v.  unir. 
univoque|Empr. au b. lat. univocu s « qui n'a qu'un son; gramm.: qui n'a qu'un seul nom », formé des élém.  uni - et  -vocu s .  Cf. équivoqu e. 
uranisme|Empr. à l'all. Uranismus , de même sens, créé en 1860 par K. H. Ulrichs, dér. du lat.  Urania , surnom d'Aphrodite.
uretère|Empr. au gr. ο υ ̓ ρ η τ η ́ ρ « même sens ». 
urètre|Empr. au b. lat. urethra  « même sens », lui-même empr. au gr. ο υ ̓ ρ η ́ θ ρ α «  id.  ». 
urbain|Empr. au lat. urbanus  , « de la ville, urbain; poli, de bon ton, plein d'urbanité; spirituel, fin »; subst. « habitant de la ville, citadin ». 
urbaine|Empr. au lat. urbanus  , « de la ville, urbain; poli, de bon ton, plein d'urbanité; spirituel, fin »; subst. « habitant de la ville, citadin ». 
urbanité|Empr. au lat. urbanitas  « qualité de ce qui est de la ville; urbanité, bon ton, politesse de mœurs; langage spirituel, esprit », dér. de  urbanus  . 
urinal|Empr. au b. lat. urinal  « pot de nuit », dér. de  urina  .  Cf.  ant.  orinal  « récipient pour l'urine » .
urgent|Empr. au b. lat. urgens « qui presse »  . 
urne|Empr. au lat. urna  « grand vase à puiser l'eau; urne de vote, de tirage au sort; urne cinéraire; mesure de capacité ». 
usurper|Empr. au lat. usurpare  «  id.  », d'abord « faire usage de », comp. de  usu  abl. de  usus, -us  « usage » et  rapere  « enlever », d'abord « entraîner avec soi ». 
ursidés|Empr. au lat. sc. ursidae  , dér. du lat.  ursus  « ours »;  ursidé  s'est imposé, pour désigner cette famille de mammifères, après des hésitations entre  urside  ,  ursin *,  ursien, ursiné  .
ursin|Empr. au lat. ursinus  « d'ours » .
usucapion|Empr. au lat. usucapio, -onis  «  id.  », comp. de  usu  ablatif de  usus, -us  « usage » et  capio  « je prends ».
usuel|Empr. au b. lat. usualis  « utile, de bon usage », et « ordinaire, général » . 
urticaire|Empr. au lat. méd. urticaria  , dér. de  urtica  « ortie* » p. anal. entre les manifestations de l'urticaire et celles provoquées par le contact des orties. 
usufructuaire|Empr. au b. lat. usufructuarius  subst. « usufruitier » dep.  ii <sup e</sup s. ds  OLD  et adj. « relatif à l'usufruit »  ii <sup e</sup s. ds  Gaff. , du lat. class.  usufructus , v.  usufruit. Cf.  le subst.  usefructaire  « usufruitier »  xiii <sup e</sup s. .
usufruit|Empr. au lat. jur. ususfructus  «  id.  »  ii <sup e</sup s. ds  OLD , comp. de  usus  « usage » et  fructus  « fruit », déjà à l'époque class.  Cf.  en a. m. fr. les formes  usefruis  «  id.  »  xiii <sup e</sup s.  − 1443,  ibid. :  usfruiz. 
utérus|Empr. au lat. uterus  « sein, ventre de la mère; ventre, flanc d'un animal ». 
utile|Empr. au lat. ūtĭlis  « qui sert, profitable, avantageux ».  Cf.  les formes empr. qui se sont maintenues avec l'accentuation lat. et relevées seulement dans les aires périphériques: a. fr. tele et tle  . 
urtication|Empr. au lat. méd. urticatio  « piquer avec des orties » , dér. de  urticare  « piquer » , lui-même dér. de  urtica  « ortie »; l'angl.  urtication  est att. dès 1655 au sens de « action de piquer, démangeaison  » .
usuraire|Empr. au lat. jur. usurarius  «  id.  »  iii <sup e</sup s. ds  OLD , d'abord « dont on a l'usage, dont on jouit », dér. de  usura , v.  usure <sup 1</sup . 
usité|Empr. au lat. usitatus  « en usage, familier, entré dans l'usage » . 
usurpateur|Empr. au b. lat. jur. usurpator, -oris  «  id.  »  iv <sup e</sup s. ds  Souter Later Latin , formé sur le supin  usurpatum  de  usurpare  « usurper ». 
usnée|Empr. à l'ar. ušna  « mousse, lichen ». Voir  Devic ;  Lammens , p. 244;  Lok.  n<sup o</sup 2139;  Nasser , p. 363;  FEW  t. 19, p. 197.
usurpation|Empr. au lat. jur. usurpatio, -onis , I<sup er</sup s. ds  OLD , class. « usage, emploi », formé sur le supin  usurpatum  de  usurpare  « usurper ». 
usurpatoire|Empr. au b. lat. jur. usurpatorius  «  id.  »  v <sup e</sup s. ds  Gaff. ; dér. de  usurpator,  v.  usurpateur . 
usurpatrice|Empr. au b. lat. jur. usurpator, -oris  «  id.  »  iv <sup e</sup s. ds  Souter Later Latin , formé sur le supin  usurpatum  de  usurpare  « usurper ». 
utilité|Empr. au lat. utilitas, -atis  « utilité, avantage, profit, intérêt », plur. « intérêts, avantages ». 
utopie|Empr. au lat. utopia nom donné par l'humaniste et homme d'État angl. Thomas More [1478-1535] à une île imaginaire jouissant d'un système soc. et pol. idéal, dans un ouvrage paru en lat. en 1516, trad. en fr. en 1550 . Sur la notion d'utopie v.  Les Utopies à la Renaissance , Presses universitaires de Bruxelles, Presses universitaires de France, 1963; J.  Servier ,  Histoire de l'Utopie , 1967; C. G.  Dubois ,  Problèmes de l'utopie , Archives des lettres modernes, 1968, n<sup o</sup 85; R.  Ruyer ,  L'Utopie et les utopies , 1950. 
utriculaire|Empr. au lat. utricularius  « fabricant ou marchand d'outres », de  utriculus  .
utricule|Empr. au lat. utriculus  « petite outre », dimin. de  uter, utris  « outre ».
uvée|Empr. au lat. médiév. uvea  « élément en forme de grappe », du lat.  uva  « raisin, grappe », p. anal. de forme et de couleur. 
uvifère|Empr. au lat. uvifer  « qui porte du raisin, qui produit de la vigne ».
uvule|Empr. au lat. médiév. uvula , au sens propre « petite grappe », dimin. de  uva  .
