taboulé|Empr. à l'ar. libanais et syrien tabbūla , même sens , dér. du verbe  tabbala  « assaisonner ».  Cf.  angl.  tabbouleh  .
tabellaire|Empr. au lat. tabellarius  « qui a rapport aux lettres »; « relatif aux bulletins de vote »; dér. de  tabella  « tablette, lettre ».
tabelle|Empr. au lat. tabella « petite planche, tablette », puis « écrit de toute sorte », p. ex. « lettre, protocole d'un interrogatoire, dépêche, message ». L'all.  Tabelle  « tableau, liste », empr. au lat. au  xvii <sup e</sup s., pourrait aussi être la source de l'empr. .
tabellion|Empr. au lat. de l'époque impériale tabellio  « notaire », dér. du lat.  tabella  « tablette ». 
tabac|Empr. à l'esp. tabaco , att. dep. la 1<sup re</sup moit. du  xvi <sup e</sup s. au sens 1 et au sens de « cigare » , lui-même empr. à l'arawak de Cuba et Haïti . A remplacé  pétun *.
tabernacle|Empr. au lat. tabernaculum  « tente », spéc. « tente augurale », dér. de  taberna  « habitation en planches », spéc. « boutique ». 
tabagie|Empr. à l'algonquin tabaguia  « festin », le sens ayant évolué de 1 à 2 sous l'infl. de  tabac <sup 1</sup *. Voir  Fried . et  FEW  t. 20, p. 80b. 
tacaud|Empr. au bret. takohed  « id. », mot plur. .
tabi|Empr. à l'ar. tābi <sup  207 </sup , plur.  tābi <sup  207 </sup  ūn  « adepte; disciple; fils spirituel; partisan; sectateur », part. actif subst. de  tabi <sup  207 </sup  a  « suivre, venir à la suite de, succéder; adopter  ».
tabide|Empr. au lat. tabidus  « corrompu; en putréfaction », dér. de  tabes  .
tabala|Empr. au wolof et bambara tabala , mot répandu parmi les populations wolof, bambara et mandingue du Sénégal, de la Gambie et du Mali ; prob. lui-même empr. à l'ar.  ṭabl  « tambour ».
tabifique|Empr. au lat. tabificus  « qui corrompt, qui désagrège », « qui mine, qui consume », dér. de  tabes  .
tabis|Empr. à l'ar. tābi <sup  207 </sup , plur.  tābi <sup  207 </sup  ūn  « adepte; disciple; fils spirituel; partisan; sectateur », part. actif subst. de  tabi <sup  207 </sup  a  « suivre, venir à la suite de, succéder; adopter  ».
tabou|Empr. au polynésien tabu, tapu  , d'abord par l'intermédiaire de l'angl.  taboo dans les trad. des voyages de J. Cook. 
tadjik|Empr. au pers. tāǰik , n. d'une population iranienne qui habite le Turkestan, le Tadjikistan, le nord de l'Afghanistan et l'est de l'Iran. 
taciturne|Empr. au lat. class. taciturnus  « taciturne, silencieux » dér. de  tacitus , v.  tacite . 
tachygraphe|Empr. au gr. τ α χ υ γ ρ α ́ φ ο ς adj. « qui écrit vite » d'où le subst. ο ̔ τ α χ υ γ ρ α ́ φ ο ς « sorte de sténographe, secrétaire ou greffier qui utilise la tachygraphie », de τ α χ υ ́ « vite », neutre adv. de τ α χ υ ́ ς et de -γ ρ α φ ο ς issu de γ ρ α φ ε ι ̃ ν « écrire, inscrire ».
tael|Empr. au port. tael  , et celui-ci au malais  tahil  . 
taciturnité|Empr. au lat. class. taciturnitas  « action de garder le silence; silence » dér. de  taciturnus, taciturne *. 
taël|Empr. au port. tael  , et celui-ci au malais  tahil  . 
tackle|Empr. à l'angl. tackle  att. dep. 1250 au sens de « équipement, attirail »  d'où, spéc., « gréement, cordage, corde » ainsi que « équipement de guerre, armes, flèche »  et « dispositif, article pour la pêche » .  NED  suppose que  tackle  est issu du b. all. et corresp. au m. néerl.  taeckel  « cordage, câble » à l'orig. du néerl.  takel  « palan » . Les sens de l'angl.  tackle  permettent également le rapprochement avec l'a. fr.  tacle  semblant désigner une arme défensive, peut-être un bouclier  , p. 13) ainsi que le m. fr. et fr. mod.  tacle  désignant un type de flèche  considérés comme d'orig. inc. ds  FEW  t. 23, fasc. 127, p. 135a-b.
tacle|Empr. à l'angl. tackle , déverbal, att. dep. 1901 comme terme de footb. ou de rugby , de  to tackle  « fournir, gréer » d'où « harnacher » puis « saisir, agripper » d'où, spéc., en sports « intercepter  »  et « faire obstruction  dans le but de prendre la balle  » . Parallèlement l'angl. emploie le subst. verbal  tackling  att. dep. 1892 . Le verbe  to tackle  est issu du subst.  tackle  qui est à l'orig. de  tackle *. 
taffetas|Empr. au pers. tāfta  « taffetas », propr. « ce qui est tissé », du verbe  tāftan  « tisser, filer, tordre » , peut-être par l'intermédiaire de l'ital.  taffettà  ; d'apr.  Hope , p. 51, le mot est att. en lat. médiév. en Italie au  xiv <sup e</sup s. 
tachine|Empr. au lat. sc. tachina , 1803 , du gr. τ α χ ι ν ο ́ ς « rapide, agile » dér. de τ α χ υ ́ ς « id. »;  tachina étant la forme du lat. sc. 
tact|Empr. au lat. tactus  « action de toucher; sens du toucher », dér. de  tangere  « toucher » . 
tactile|Empr. au lat. tactilis  « tangible, palpable », dér. de  tactum , supin de  tangere  « toucher »  ; suff.  -ilis . 
tagète|Empr. au lat. sc. mod. tagetes  « id. » 1542 , de  Tages  n. d'une divinité étrusque.
tacite|Empr. au lat. class. tacitus  « dont on en parle pas » et « qui ne parle pas » part. passé adj. de  tacere  « se taire; taire » . 
talc|Empr. à l'ar. ṭalq , même sens.  Cf.  le lat. médiév.  talc, talcum  . 
talent|Empr. au lat. talentum , sens II 1, 2; empl. fig. à basse époque « richesse, richesse morale »  [3]. L'explication de I se trouve dans l'interprétation de la parabole évangélique par l'exégèse médiév.; celle-ci s'exprime par différents aut.: dès le  iv <sup e</sup s., les  talenta  sont considérés par St Jérôme comme « don de Dieu, grâce » . D'apr. le même aut.,  ibid. , les 5 talents distribués par le maître au 1<sup er</sup serviteur représentent  omnes sensus  « les 5 sens corporels »; les 2 talents signifient l' intelligentia  « les capacités intellectuelles, les facultés de l'esprit » et l' opera  [ operatio ] ; le talent unique signifie la  ratio  « faculté intellectuelle ». De  talenta  « les 5 sens corporels », est dér. le sens « capacités physiques ». Du sens « faculté de l'esprit » , est issu, par synecdoque, celui de « esprit », att. dès le  xi <sup e</sup s. . 
taillade|Empr. à l'ital. tagliata  « entaille » , part. passé fém. subst. de  tagliare  « tailler », du lat. pop.  *taliare , v.  tailler. 
taillole|Empr. à l'a. prov. talhola  « id. » , de  talhar  « tailler », du lat. tardif  *taliare , v.  tailler . 
talion|Empr. au lat. talio, -onis  « id. », dér. de  talis  « tel ». 
talisman|Empr. au persan ṭilism , plur.  ṭalāsim, ṭilismāt  « talisman, amulette; incantation, charme; sortilège », lui-même empr. à l'ar.  ṭilasm, ṭillasm , plur.  ṭalāsim, ṭilasmāt, ṭilassamāt  « talisman, charme », et celui-ci au gr. τ ε ́ λ ε σ μ α « imposition, impôt, contribution; rite religieux », gr. byz. « objet consacré, talisman » . La termin.  -an  de  talisman  est d'orig. obsc.; d'apr.  Cor. , elle pourrait s'expliquer par une confusion partielle avec l'homon.  talisman  « docteur de la loi musulmane »  ou par l'hyp. d'un empr. au persan  ṭilismān , plur. vulg., non att. ds les dict., de  ṭilism ; d'apr.  FEW  t. 19, p. 187, la termin.  -an  s'expliquerait par un empr. à l'ar.  ṭilasmān , duel de  ṭilasm. 
taïole|Empr. à l'a. prov. talhola  « id. » , de  talhar  « tailler », du lat. tardif  *taliare , v.  tailler . 
talit|Empr. à l'hébr. mishnaïque ṭallι ̄th  « couverture, manteau, châle de prière », prob. dér. de l'hébr. biblique  ṭillēl  « couvrir, surmonter d'un toit » ou de l'araméen  ṭallēl  « couvrir ».
talitre|Empr. au lat. sc. talitrus  « id. » 1802 , du class.  talitrum  « chiquenaude », dér. de  talus  « talon », l'animal faisant de petits sauts.
tajine|Empr. à l'ar. ṭāǧin, ṭāǧ ι ̄n  « plat de terre qui ressemble à une poêle à frire; tout ce que l'on cuit ou rôtit dans cet ustensile » , lui-même empr. au gr. τ α ́ γ η ν ο ν, τ η ́ γ α ν ο ν « poêle à frire » .
talle|Empr. au lat. thallus  « tige d'une plante garnie de ses feuilles », du gr. θ α λ λ ο ́ ς « jeune pousse », v.  thalle ;  cf.  le synon.  tallée  1892  − 1925,  Genevoix ,  Raboliot , p. 100. 
tallipot|Empr. au malay ālam  tālipat , hindi  tālpāt , du skr.  tālapattra  « feuille de tala », comp. de  tāla  « palmier » et  pattra  « feuille »;  cf.  l'angl.  talipot  « id. » dep. 1681 ds  NED :  tallipot .
talapoin|Empr. au port. talapão, talapoi  « id. » 1544 ds  Dalg. , d'un vx dial. birman de Pegu  tala pôi  « monseigneur » titre des moines bouddhistes  ou p. ext. de sens du pāli  talapannan « grand éventail de tala » que portent les religieux bouddhistes . 
talmouse|Empr. à l'ar. ṭalmūsa  « pâtisserie, gâteau », de l'ar. de Syrie qui se rattache à la racine sémitique  ṭlm  « aplatir et plier la pâte  », v.  Baldinger Etymol.  1, n<sup o</sup 1688.
talmud|Empr. à l'hébr. mishnaïque talmūd  « enseignement; étude; Talmud », dér. de  lāmad  « apprendre, étudier ». 
tambourinaire|Empr. au prov. tambourinaire  « tambourineur, joueur de tambourin », dér., au moyen du suff.  -aire  , du verbe  tambourina  « jouer un air sur le tambourin, battre le tambourin ou le tambour », dér. de  tambourin  « tambourin ».  Cf.  l'a. prov.  taborinayre et le fr.  tambourineur  .
tamoul|Empr. au tamoul Tamiṛ, Tamiḷ « tamoul », issu du skr. Dravidạ « Dravidiens » à travers les formes intermédiaires Dramiḍa, Dramiḷa, Damiḷa  . En port.,  tamul  est att. dès 1516  et 1579 .
tamoule|Empr. au tamoul Tamiṛ, Tamiḷ « tamoul », issu du skr. Dravidạ « Dravidiens » à travers les formes intermédiaires Dramiḍa, Dramiḷa, Damiḷa  . En port.,  tamul  est att. dès 1516  et 1579 .
tamarin|Empr. à une lang. indienne de l'Amazone, prob. le tupi .
tamaris|Empr. au lat. tamarix ,  tamarice, -es  ; b. lat.  tamariscus  ,  tamaricium « tamaris », v.  André Bot. ,  Cf.  l'a. prov.  tamaris  ,  tamarisc  , auquel, d'apr.  Thomas  .  Essais , p. 76, aurait été empr. le n. fr. de cette plante méditerranéenne. 
tambour|Empr. soit au persan tabι ̄r  « tambour » , peut-être avec infl. de l'ar.  ṭunbūr  « instrument à cordes, ordinairement formé d'un corps creux sur lequel est tendue une peau », soit à l'ar.  ṭubūl , plur. de  ṭabl  « tambour » , peut-être également avec infl. de l'ar.  ṭunbūr  . 
tandem|Empr. à l'angl. tandem , utilisation du mot lat.  tandem  « à la fin, enfin, à la longue » au sens concr., par calembour, de « en longueur » att. dep. 1785 au sens 1, dep. 1795 à l'empl. adv. signifiant « l'un devant l'autre » en parlant d'attelages de chevaux puis d'autres choses  et dep. 1884 pour désigner une  bicyclette  p. abrév. de  tandem bicycle  . Les empl. p. réf. à des objets ou des personnes en couple indépendamment de la disposition possible n'apparaissent qu'au  xx <sup e</sup s. en angl. . 
tangent|Empr. au lat. tangens , part. prés. de  tangere  « toucher ». 
tank|Empr. d'abord au port. tanque  att. dep. la fin du  xv <sup e</sup s.  puis à l'angl.  tank  att. dep. le déb. du  xvii <sup e</sup s.  et dont les 1<sup res</sup formes laissent supposer une infl. du port. L'orig. du terme port. n'est pas clairement établie, le lien avec  estancar  corresp. au fr.  étancher * n'étant pas certain. L'hyp. d'une orig. indienne n'est pas à exclure. Dans ce cas, les formes corresp. relevées en Inde  seraient autochtones et le terme angl. aurait été directement empr. à une lang. de l'Inde après avoir d'abord été introduit dans l'usage par l'intermédiaire du portugais.
tangente|Empr. au lat. tangens , part. prés. de  tangere  « toucher ». 
tanker|Empr. à l'angl. tanker , dér. de  tank  « citerne »  et att. dep. 1900 dans la désignation de navires-citernes  puis de véhicules terrestres  et d'avions . Le  Comité d'ét. des termes techn. fr.  propose de traduire cet anglicisme par  navire citerne , ou, plus précisément et selon la nature de la cargaison,  pétrolier, butanier, méthanier  ; l'arrêté du 12 janv. 1973 recommande l'usage de  navire-citerne  et de  pétrolier  .
tangible|Empr. au lat. de basse époque tangibilis  « qui peut être touché, palpable », dér. du lat. class.  tangere  « toucher ». 
tarabouk|Empr. à l'ar. darabukka  , avec altér. de l'init. . 
tapioca|Empr. au port. tapioca  , lui-même empr. au tupi  typy ca, tapioca, tipioca , signifiant propr. « ce qui est caillé, coagulé ». Voir  Fried. ,  König , pp. 198-199, et  FEW  t. 20, p. 81a.
tarama|Empr. au gr. mod. τ α ρ α μ α ̃ ς « œufs de poisson salés » , du turc  tarama  « œufs, laitance »;  cf.  l'angl.  tarama salata  « id. » dès 1910 ds  NED Suppl. <sup 2</sup ,  s.v. taramosalata  et  tarama  « id. » 1972,  ibid. 
tarasque|Empr. à l'a. prov. tarasca  «  id.  », 1369  du n. de la ville de  Tarascon  dans les Bouches-du-Rhône où l'on promène sa représentation par un mannequin au cours d'une procession. 
tarbouch|Empr. à l'ar. ṭarbūš « bonnet de drap ou de laine rouge garni d'une houppe au sommet » Vêt. , pp. 250-254), lui-même empr. au turc  tarpoş , qui serait comp. du turc  ter  « sueur » et du persan  pūš , de  pūš ι ̄dan  « couvrir » ,  cf.  K.  Vollers  ds  Z. der deutschen Morgenländischen Gesellschaft  t. 51, p. 308;  Lok. , n<sup o</sup 2031;  Klein Etymol. ,  s.v. tarboosh . 
tarbouche|Empr. à l'ar. ṭarbūš « bonnet de drap ou de laine rouge garni d'une houppe au sommet » Vêt. , pp. 250-254), lui-même empr. au turc  tarpoş , qui serait comp. du turc  ter  « sueur » et du persan  pūš , de  pūš ι ̄dan  « couvrir » ,  cf.  K.  Vollers  ds  Z. der deutschen Morgenländischen Gesellschaft  t. 51, p. 308;  Lok. , n<sup o</sup 2031;  Klein Etymol. ,  s.v. tarboosh . 
targe|Empr. à l'a. b. frq. *  targa  qui a dû signifier « bouclier » et que l'on suppose d'apr. l'ags.  targe  fém.;  targa  masc. et l'a. nord.  targa  « bouclier », v.  FEW  t. 17, pp. 315b-316a. 
tarot|Empr. à l'ital. tarocchi  « tarots », att. dep. le  xvi <sup e</sup s. , dér. de  tara  « perte de valeur que subit une marchandise; déduction, action de défalquer »  parce que dans ce jeu le joueur doit, dans certains cas, mettre une carte de côté. Voir G.  de Gregorio  ds  Z. rom. Philol.  t. 49, p. 531 et  FEW  t. 19, p. 183;  cf.  K.  Baldinger  ds  Mél. H. Lewicka , 1976, p. 26, note 38. 
targum|Empr. à l'hébr. mishnaïque targūm  « interprétation, traduction, version »; spéc. « Targum, traduction ou paraphrase araméenne de la Bible », dér. de l'hébr. biblique  tirgēm  « traduire » .
taricheute|Empr. au gr. τ α ρ ι χ ε υ τ η ́ ς « qui sale ou embaume », de τ α ρ ι χ ε υ ́ ω de τ α ́ ρ ι χ ο ς « conserve, momie ».
tarpan|Empr. au kirghize de mêmes forme et sens.
tarpéien|Empr. au lat. Tarpeius « le Mont Tarpéien, qui désigne le Capitole »,  Saxum Tarpeium, Tarpeia rupes  « roche tarpéienne, point de la montagne duquel on précipitait les criminels ». 
tarif|Empr. à l'ital. tariffa  , et celui-ci à l'ar.  tar ι ̄f  « notification, information; définition, détermination » , n. d'action du verbe  arrafa  « annoncer, informer, faire connaître », 2<sup e</sup forme de  arafa  « connaître, savoir ». 
tarpon|Empr. à l'angl. tarpon  , peut-être du néerl.  tarpoen , d'orig. obsc. .
tardigrade|Empr. à l'adj. lat. tardigradus  « qui marche lentement » . 
tarse|Empr. au gr. τ α ρ σ ο ́ ς « rangée des doigts au bout du pied », « le pied lui-même ». 
tardigrades|Empr. à l'adj. lat. tardigradus  « qui marche lentement » . 
tarir|Empr. à l'a. b. frq. *  tharrjan  « sécher »;  cf.  l'a. h. all.  therren  « id. », m. h. all.  derren  « id. », v.  FEW  t. 17, p. 393b. 
tartir|Empr. au fourbesque tartire  « déféquer » , d'abord  tortire  « id. » , de l'ital.  tortire  « tordre » , lui-même empr. à l'a. et m. fr.  tortir  « tordre, se tordre » , dér. du lat.  tortus , part. passé de  torquere  « tordre » .
tarentelle|Empr. à l'ital. tarantella , n. d'une danse et de la musique accompagnant cette danse, att. dep. 1688 , d'abord « tarentule » , altér. de  tarantola  ; la confusion des deux mots s'expliquerait par le fait que la musique était considérée comme bénéfique pour les malades mordus par une tarentule ; A.  Paré ,  loc. cit. ,  s.v. tarente ; 1787,  Compan ,  s.v. Tarentule  . Voir  FEW  t. 13, 1, p. 121a. 
tartan|Empr. à l'angl. tartan , terme d'orig. obsc. att. dep. le déb.  xvi <sup e</sup s. et désignant un tissu écossais dont le dessin des couleurs est caractéristique de chaque clan et qui est notamment utilisé pour constituer le  plaid  et le  kilt  et, p. méton., désigne le dessin du tissu ou celui qui en est revêtu . Rien ne confirme l'hyp. d'une orig. dans le fr.  tiretaine *, à partir de la forme  tertaine  att. en 1487 ds  Gdf. Compl. , ni dans l'a. fr.  tartaire, tartaine qui désigne une riche étoffe de soie. 
tarentule|Empr. à l'ital. tarantola  « lézard »  et « grosse araignée venimeuse » , dér. de  taranta  « id. ».  Cf. tarente . 
tarmacadam|Empr. à l'angl. tar macadam , comp. de  macadam * et de  tar  « goudron, bitume » , att. dep. 1885 .
tartare|Empr. au lat. médiév. Tartarus  « Tartare, Mongol »  ca  1250 ds  Latham  , altér. sous l'infl. de  Tartarus  désignant l'enfer dans la mythol. gréco-romaine , d'un mot d'orig. turco-mongole introd. à l'époque de Gengis Khan avec finale  -ar  de plur., prob. a. turc  tatar  « habitant de la région nord de la Chine » en rel. avec le mongol  tatari  « bègue »  Vasmer  t. 3, p. 81 , mentionné au  ix <sup e</sup s. dans les ann. chinoises  pour désigner une tribu de Mongols ou de Turcs, puis étendu à un grand nombre de tribus d'Asie Centrale, v.  Nouv. Lar. ill. Cf.  le subst.  Tartarin  au sens 1 a  ca  1244  − 1606,  Nicot , lat. médiév.  Tartarinus  « id. » 1240 ds  Du Cange , les adj.  tartarien  «  qui est Tartare »  xiv <sup e</sup s. , et  tartaresque  « id. » 1403  − 1605, P.  Le Loyer ,  Hist. d. spectres , 334c,  ibid. , déjà subst. fin  xiii <sup e</sup s.  tartaresce  « langue tartare » . 
tasse|Empr. à l'ar. ṭāsa, ṭassa  « coupe, tasse, écuelle », lui-même empr. au persan  tašt  « tasse, soucoupe » . Le mot est très prob. parvenu en fr. par l'intermédiaire du prov. et/ou de l'ital.:  cf.  prov.  tassa  , ital.  tazza  ; esp.  taza  , lat. médiév. en domaine prov.  tassa, tassia et en domaine ital. tassia  ; au sens 3 a, expr. répandue à la suite des noyades de Nantes ,  cf. Brunot  t. 9, p. 885. 
tartre|Empr. au b. lat. tartarum  « tartre », d'orig. obsc. , d'où aussi les formes  tartharum  « tartre de vin » , tartare  . Voir  FEW  t. 13, 1, p. 126. 
tatou|Empr. au tupi tat « tatou ». Voir  König , p. 201 et  Fried. 
tassili|Empr. au touareg tasîlé  « vaste massif montagneux couronné de grands plateaux rocheux sans sommets dominant notablement ces plateaux » .
tatouer|Empr. à l'angl. to tattoo  att. dep. 1769 dans le récit du voyage de J. Cook  et issu du polynésien  ta  tau  « tatouage », terme mentionné à propos de Tahiti dans le récit de J. Cook  et dans celui du voyage de Bougainville . 
tartufe|Empr. à l'ital. tartufo , att. dans un sens péj.  dep. 1606 , issu p. métaph. de  tartufo  « truffe », du lat. pop.  *terrae tufer  « id. » où  *tufer  représente la forme osco-ombrienne du lat.  tuber. Cf.  ital.  truffa  « truffe », puis « plaisanterie » et « tromperie » , et fr.  truffe * qui subit la même évol. en a. et m. fr. . Au vu de l'attest. 1609  supra , Molière n'a pas inventé le nom de  Tartuffe , mais c'est sa comédie  qui est à l'orig. de la diffusion du mot dans la lang. cour. 
tartuffe|Empr. à l'ital. tartufo , att. dans un sens péj.  dep. 1606 , issu p. métaph. de  tartufo  « truffe », du lat. pop.  *terrae tufer  « id. » où  *tufer  représente la forme osco-ombrienne du lat.  tuber. Cf.  ital.  truffa  « truffe », puis « plaisanterie » et « tromperie » , et fr.  truffe * qui subit la même évol. en a. et m. fr. . Au vu de l'attest. 1609  supra , Molière n'a pas inventé le nom de  Tartuffe , mais c'est sa comédie  qui est à l'orig. de la diffusion du mot dans la lang. cour. 
taurobole|Empr. au b. lat. des inscriptions taurobolium, -ii  « id. », du gr. τ α υ ρ ο β ο ́ λ ι ο ν « id. », dér. de τ α υ ρ ο β ο ́ λ ο ς « qui immole un taureau », comp. de τ α υ ̃ ρ ο ς « taureau » et β α ́ λ λ ω « frapper ». 
tautologie|Empr. au b. lat. gramm. tautologia  « id. »  iv <sup e</sup s. ds  Blaise Lat. chrét. , du gr. τ α υ τ ο λ ο γ ι ́ α «  id.  », dér. de τ α υ τ ο λ ο ́ γ ο ς « qui redit la même chose », comp. de τ α υ ̓ τ ο ́ crase attique pour τ ο ̀ α υ ̓ τ ο ́ neutre de ο ̔ α υ ̓ τ ο ́ ς « le même » et λ ε ́ γ ω « dire ».  Cf.  la forme  taftologie  « id. »  Trév.  1704-1771. 
taxation|Empr. au lat. taxatio  « estimation, appréciation », et à basse époque, dans la lang. jur. « clause, condition d'un acte », dér. de  taxatum , supin de  taxare  . La forme  taxation  , il n'est pas impossible que  tax-  soit aussi une forme fr.) a évincé progressivement la forme  taussation . V.  Festschrift für Johannes Hubschmid , 1982, pp. 700-701. 
taurin|Empr. au lat. taurinus  « de taureau, de bœuf », dér. de  taurus  « taureau ». 
taxer|Empr. au lat. taxare  « toucher souvent et fortement; blâmer, reprendre, estimer, évaluer », lui-même empr. au gr. τ α ́ σ σ ε ι ν « ranger, fixer » . La forme  taxer  a évincé  tausser  . 
taurine|Empr. au lat. taurinus  « de taureau, de bœuf », dér. de  taurus  « taureau ». 
tchador|Empr. au persan čādor  « tente; voile ». Mot répandu en 1978 lors des événements qui précédèrent l'instauration de la république islamique en Iran, en 1979. 
tcharchaf|Empr. au turc çarşaf  « drap de lit; voile dont se couvrent les femmes pour sortir de chez elles » . 
tchèque|Empr. au tch. Čech  « un Tchèque »,  český «  tchèque », v. aussi  Lang. Monde , p. 67. 
tchérémisse|Empr. au russe čeremis  désignant un peuple finno-ougrien de la Haute-Volga  et sa lang. .
tcherkesse|Empr. au russe čerkes  désignant un peuple du nord-ouest du Caucase  et sa lang.,  cf. Lang. Monde , p. 240. 
tchibouk|Empr. au turc çubuk  « baguette; tube, tuyau; pipe; fume-cigarette » .
technicolor|Empr. à l'angl. Technicolor , n. déposé aux États-Unis , désignant différents procédés de cin. en couleurs et formé à partir de  technic  « technique » et  color  « couleur ».
technique|Empr. au gr. τ ε χ ν ι κ ο ́ ς « qui concerne un art » dér. de τ ε χ ́ ν η « art manuel ». 
technologie|Empr. au gr. τ ε χ ν ο λ ο γ ι ́ α « traité sur un art, exposé des règles d'un art », dér. de τ ε χ ν ο λ ο ́ γ ο ς « qui traite d'un art ou des règles d'un art ». 
tee|Empr. à l'angl. tee , d'abord att. sous la forme  teaz  , d'orig. inc., et désignant un point de départ de la balle de golf, constitué gén. par une petite surélévation en sable puis par une sorte de cheville de bois ou de matière plastique au sommet concave . Le  Vocab. techn. du golf  des  Cah. de l'Office de la lang. fr. , Québec, 1971, n<sup o</sup 9 remplace ce terme par  dé . 
tefilin|Empr. à l'hébr. mishnaïque t <sup  e </sup  phillι ̄n , plur. de  t <sup  e </sup  phillā <sup  h </sup « prière; phylactère », de l'hébr. biblique  t <sup  e </sup  phillā <sup  h </sup « prière » .
teck|Empr. au port. teca  « teck, bois de teck » , lui-même empr. au tamoul ou malayalam  tēkku .
tefillin|Empr. à l'hébr. mishnaïque t <sup  e </sup  phillι ̄n , plur. de  t <sup  e </sup  phillā <sup  h </sup « prière; phylactère », de l'hébr. biblique  t <sup  e </sup  phillā <sup  h </sup « prière » .
tek|Empr. au port. teca  « teck, bois de teck » , lui-même empr. au tamoul ou malayalam  tēkku .
tell|Empr. à l'ar. tall  « colline, monticule, butte, tertre; Tell, partie septentrionale de l'Algérie, par opposition à Sahara ». Au sens 2,  cf.  l'angl.  tell  . 
telline|Empr. au gr. τ ε λ λ ι ́ ν η «  id.  ».  Cf.  l'a. prov.  tellina  « id. » 1439 ds  Pansier .
temporaire|Empr. au lat. temporarius  « dépendant des circonstances » et « qui ne dure qu'un temps limité ». 
temporal|Empr. au b. lat. temporalis  « de la tempe, temporal » . 
tempérament|Empr. au lat. temperamentum  « combinaison proportionnée des éléments d'un tout, combinaison, proportion, mesure »;  cf.  l'a. prov.  temperament  « modération; mesure » . L'a. et m. fr. employait en ce sens  atemprement , dér. de  atemprer  « modérer, adoucir » du lat.  attemperare  « ajuster, adapter » et utilisé jusqu'au  xvi <sup e</sup s. ; on relève aussi  temprement  . 
tempérance|Empr. au lat. temperantia  « modération, mesure, retenue », « sobriété »; l'a. fr. avait aussi en ce sens  temprance , dér. de  temprer  « mélanger, modérer », du lat.  temperare , v.  tempérer  et  atemprance , v.  tempérament . 
temporalité|Empr. au lat. chrét. temporalitas  « caractère de ce qui est éphémère, par opposition à l'éternité » et « circonstances » qui a pris à l'époque médiév. le sens de « biens, possessions matérielles du clergé » . 
tempérant|Empr. au lat. temperans  « retenu, modéré », part. prés. de  temperare  . 
temporel|Empr. au lat. temporalis  « éphémère, qui ne dure qu'un temps », « ce qui se rapporte au monde terrestre  » et terme de gramm. « qui concerne le temps »;  temporalis  est att. comme subst. par  St Augustin  au sens de « pouvoir séculier ». 
température|Empr. au lat. temperatura  « constitution régulière, composition bien dosée, équilibrée », « proportions d'un alliage », « constitution physique », « température ». 
tempéré|Empr. au lat. temperare  « combiner dans de justes proportions », « disposer convenablement les éléments d'un tout », « organiser, régler », « modérer, tempérer, équilibrer, régulariser »; l'a. fr. utilisait surtout en ces sens  temprer , v.  tremper ;  cf.  aussi le prov.  temperat  . 
tempérer|Empr. au lat. temperare  « combiner dans de justes proportions », « disposer convenablement les éléments d'un tout », « organiser, régler », « modérer, tempérer, équilibrer, régulariser »; l'a. fr. utilisait surtout en ces sens  temprer , v.  tremper ;  cf.  aussi le prov.  temperat  . 
tempétueux|Empr. au b. lat. tempestuosus  « orageux », fig. « violent » .  Cf.  le synon. a. fr.  tempestos  , dér. de  tempête *; suff.  -eux *. 
temple|Empr. au lat. templum  « espace tracé par l'augure dans l'air et sur la terre, à l'intérieur duquel il recueille et interprète les présages; espace que la vue embrasse, champ de l'espace; espace inauguré, consacré; spéc.: le temple ». Dans la lang. chrét., à côté d' ecclesia  et de  basilica, templum  désigne à partir des  iii <sup e</sup et  iv <sup e</sup s. l'édifice du culte, le sanctuaire ; terme de mystique, il désigne le corps, demeure du Saint-Esprit , la communauté des chrétiens, l'Église .  Templum  « Temple de Jérusalem » est relevé dans la  Vulgate  ; au fig., il désigne le corps du Christ . Au Moy. Âge, il désigne l'Ordre fondé en 1119, à Jérusalem par Hugues de Payns et qui s'installa quelques années après, dans un édifice voisin de l'ancien Temple de Salomon: 1142, déc. Rouergue  fratres Templi  ds  Brunel , 39, p. 44;  id.  a. prov.  cavalleirs del Temple ,  ibid. , v. aussi  tempe <sup 2</sup . 
tenace|Empr. au lat. tenax, -acis  « qui tient fortement, parcimonieux, adhérent, obstiné, opiniâtre », dér. de  tenere  « tenir* ». 
tennis|Empr. à l'angl. tennis  désignant le jeu de paume et représentant la forme altérée de la 2<sup e</sup pers. du plur. de l'impér. du verbe fr.  tenir *, exclam. du joueur qui lançait la balle  » ds  NED ,  cf.  aussi  tennis  traduisant  paulme  ds  Cotgr.  1611). Au sens 2, empr. à l'angl.  lawn tennis  comp. de  tennis  et de  lawn  « gazon », att. dep. 1874 et désignant un nouveau type de jeu de paume de plein air appelé ensuite  tennis  p. ell. de  lawn d'où l'expr.  real tennis  « vrai tennis » désignant alors la paume traditionnelle, . Pour le sens 3,  cf.  l'angl.  tennis flannels  « pantalon de tennis en flanelle » , le sens 4  cf. tennis ground  , le sens 5  tennis shoes et pour  tennis de table  l'angl.  table tennis  avant la création de  ping-pong  . 
tendelet|Empr. à l'ital. tendaletto , att. au sens 1 en 1600  mais prob. plus anc., dér. dimin. de  tendale  «  id.  » , dér. de  tenda  . Voir  FEW  t. 13, 1, pp. 195b-196a et  Fennis Stolon. , pp. 510-511. 
tender|Empr. à l'angl. tender  « serveur, aide, assistant » att. dep. le  xv <sup e</sup s. et dér. de  to tend  « prêter l'oreille ou l'attention à, s'occuper de, servir » issu, p. aphérèse, de  to attend, entend  et  intend  de même orig. que  attendre * et  entendre *. L'angl.  tender  est att. dep. le  xvii <sup e</sup s.  comme terme désignant une embarcation au service d'un plus grand navire effectuant son approvisionnement ou différentes manœuvres et activités sous son commandement, d'où son empl. dans les chemins de fer . 
tension|Empr. au lat. de l'époque impériale tensio  « tension »; « manière de tendre  »; en méd. « contraction des nerfs », dér. de  tensum , supin de  tendre  « tendre ». 
teneur|Empr. au lat. tenor  subst. masc. « mouvement, processus continu  [en partic. dans le syntagme  uno tenore  « d'un même cours, d'une manière égale »] », « suite, continuité , uniformité  », « accent de la voix, ton », « manière ; cours  » et, à basse époque chez les juristes « dispositions  ». En a. m. fr. a vécu également un autre subst. fém.  tenor, tenour, teneur  « terres, domaine  », dér. de  tenir  au sens qu'avait pris le mot dans le cont. de la féod. , att. du  xii <sup e</sup s. au  xv <sup e</sup s. .
tentateur|Empr. au lat. chrét. temptator  « le tentateur », c.-à-d. « le Diable qui entraîne au péché », déjà utilisé en lat. class. au sens « qui attente; séducteur », dér. de  temptare  . 
tentation|Empr. au lat. chrét. temptatio  « excitation, entraînement au péché » déjà utilisé en lat. class. au sens de « essai, expérience », dér. de  temptare  . 
tercet|Empr. à l'ital. terzetto  « strophe de trois vers » , dér. dimin. de  terza  . 
tentative|Empr. au lat. scolast. tentativa  « épreuve universitaire » . Le sens II s'est développé à partir du verbe  tenter *. 
tentatrice|Empr. au lat. chrét. temptator  « le tentateur », c.-à-d. « le Diable qui entraîne au péché », déjà utilisé en lat. class. au sens « qui attente; séducteur », dér. de  temptare  . 
teraphim|Empr. à l'hébr. biblique t <sup  e </sup  rāphι ̄m  « statues d'idoles; dieux domestiques ».
tephilin|Empr. à l'hébr. mishnaïque t <sup  e </sup  phillι ̄n , plur. de  t <sup  e </sup  phillā <sup  h </sup « prière; phylactère », de l'hébr. biblique  t <sup  e </sup  phillā <sup  h </sup « prière » .
tenthrède|Empr. au lat. sc. tentredo  , adapt. du gr. τ ε ν θ ε η δ ω ́ ν « sorte de guêpe ».
tergiversation|Empr. au lat. tergiversatio  « tergiversation, lenteur calculée, détour », dér. de  tergiversari  . 
termite|Empr. au lat. tardif termes, -itis , corresp. au lat. class.  tarmes, -itis  « termite, ver qui ronge le bois » et dont l'usage fréq. au plur.  termites  est à l'orig. de l'empl. des formes  termites  au plur. et  termite  au sing. en fr. comme en angl. , à côté de la forme  termès  . 
tergiverser|Empr. au lat. tergiversari  « tourner le dos; user de détours, d'échappatoires » . 
terramare|Empr. à l'ital. terramara , att. au sens 1 dep. 1822 ,  comp. de  terra  « terre » et  amara  « amère », peut-être corruption de  terra mala  « mauvaise terre » .
ternaire|Empr. au lat. ternarius  « qui contient le nombre trois, ternaire », de  terni  « chaque fois trois, par trois », « trois ». 
terminal|Empr. au lat. d'époque impériale terminalis, -e  « relatif aux limites, aux bornes » et « final, qui forme la conclusion », dér. de  terminus  . 
terminale|Empr. au lat. d'époque impériale terminalis, -e  « relatif aux limites, aux bornes » et « final, qui forme la conclusion », dér. de  terminus  . 
terminateur|Empr. au lat. d'époque impériale terminator, -oris  « celui qui pose des bornes, qui délimite ».
terminé|Empr. au lat. terminare  « borner, limiter, clore, finir ». 
terminer|Empr. au lat. terminare  « borner, limiter, clore, finir ». 
testatrice|Empr. au lat. testator, oris  « celui qui rend témoignage; testateur », b. lat. jur.  testatrix, icis  « celle qui teste »; v. aussi  -esse <sup 2</sup .  Cf. testamenteur  ,  testamenteresse  , dér. de  testament <sup 1</sup *; suff.  -eur <sup 2</sup *,  -esse <sup 2</sup *. 
terrestre|Empr. au lat. terrestris  « qui vit sur terre  », « relatif à la terre » et « relatif au monde mortel », dér. de  terra  « terre ». 
tester|Empr. au lat. testari  « déposer comme témoin; témoigner, attester; faire son testament ». 
territoire|Empr. au lat. territorium  «  id.  », dér. de  terra  « terre »; v. aussi  terroir , forme pop. issue de  territorium . 
tessère|Empr. au lat. tessera  « dé à jouer; petit dé, tessère servant à la marqueterie ou à la mosaïque », également sens 1 et 2.
terreur|Empr. au lat. terror  « terreur, épouvante » [ terrorem inferre ;  terror belli ]; « objet qui inspire la terreur ».  Cf.  l'a. prov.  terror  « menace grave, intimidation » terme de dr. 1254 doc. Arch. Narbonne ds  Levy Prov. 
tessiture|Empr. à l'ital. tessitura  «tissage, objet tissé» , aussi terme de mus. , dér. de  tessere  . 
testicule|Empr. au lat. testiculus  « testicule », dér. de  testis  «  id.  », les testicules étant considérés comme les signes, les témoins de la virilité;  cf.  l'a. fr.  tesmoings , plur. «  id.  » . 
testimonial|Empr. au b. lat. testimonialis  « qui rend témoignage, qui atteste » ; terme jur.  testimoniales  [ litterae ] « certificat » . 
teston|Empr. à l'ital. testone , n. d'une anc. monnaie att. dep. la 2<sup e</sup moit. du  xiii <sup e</sup s. , propr. « grosse tête », ainsi nommée en raison de l'effigie gravée sur cette monnaie, dér. de  testa  . 
terrible|Empr. au lat. terribilis  « effrayant, épouvantable », à basse époque « vénérable » . 
testacé|Empr. au lat. testaceus, -a, -um « de terre cuite, de couleur de terre cuite, recouvert d'une écaille ou d'une coquille ». 
testament|Empr. au lat. testamentum  « testament, dernières volontés » , le mot, dér. de  testari , signifiant propr. « prise à témoin », le testament étant d'abord une déclaration orale faite aux  comitia calata  avec l'assemblée du peuple pour témoin, puis faite  per aes et libram  avec le concours de témoins . Dans la lang. chrét. ,  testamentum  a servi à traduire le gr. δ ι α θ η ́ κ η « disposition, alliance; alliance entre Dieu et les hommes »  et désigne également le livre attestant cette alliance . 
terrifier|Empr. au lat. terrificare  « effrayer, épouvanter ». 
testamentaire|Empr. au lat. testamentarius  « de testament, testamentaire »;  cf.  1387  lettres testamentoires  , dér. de  testament <sup 1</sup *; suff.  -oire , v.  -oir. 
terrifique|Empr. au lat. terrificus  « effrayant, terrible ». 
terrigène|Empr. au lat. terrigenae , subst. plur. littéral. « nés de la terre » , mot de la poésie qui désigne « les premiers hommes ; les Titans et les Géants » et à l'adj. plus tardif  terrigenus  , calques de l'adj. gr. γ η γ ε ν η ́ ς « né de la terre », en partic. en parlant des premiers hommes  et en partic. de sa subst. ο ι ̔ Γ η γ ε ν ε ι ̃ ς plur. « les Titans et les Géants  ».
testateur|Empr. au lat. testator, oris  « celui qui rend témoignage; testateur », b. lat. jur.  testatrix, icis  « celle qui teste »; v. aussi  -esse <sup 2</sup .  Cf. testamenteur  ,  testamenteresse  , dér. de  testament <sup 1</sup *; suff.  -eur <sup 2</sup *,  -esse <sup 2</sup *. 
teuton|Empr. au lat. Teutonus , sing. de  Teutoni  « teutons  ». 
teutone|Empr. au lat. Teutonus , sing. de  Teutoni  « teutons  ». 
teutonique|Empr. au lat. Teutonicus  « qui concerne les Teutons », dér. de  Teutoni , v.  teuton . 
teutonne|Empr. au lat. Teutonus , sing. de  Teutoni  « teutons  ». 
texte|Empr. au lat. textus  « tissu, trame »; « enchaînement d'un récit »; « texte, récit » dès le  ix <sup e</sup s., désigna l'évangile dans la liturgie , dér. de  texere  « tisser ». 
textile|Empr. au lat. textilis  « tissé »; « tressé, entrelacé », dér. de  texere  « tisser ». 
textuaire|Empr. au lat. médiév. tardif textuarius , dér. de  textus  « texte ».
textuel|Empr. au lat. médiév. tardif textualis , dér. de  textus  « texte ». 
thalamite|Empr. au gr. θ α λ α μ ι ́ τ η ς « rameur », dér. de θ α ́ λ α μ ο ς « chambre à l'intérieur d'une maison », spéc. « sorte de grande chambre longue et étroite formée par les plats-bords du navire où étaient placés les rameurs inférieurs ».
texture|Empr. au lat. textura  « tissu; contexture », dér. de  texere  « tisser »; on rencontre en a. fr. la forme  tisture d'apr. le verbe  tistre , v.  tisser. 
thalassocratie|Empr. au gr. θ α λ α σ σ ο κ ρ α τ ι ́ α « empire de la mer », comp. de θ α ́ λ α σ σ α « mer » et -κ ρ α τ ι α dér. de κ ρ α τ ε ́ ω « être le maître ». 
thématique|Empr. au gr. θ ε μ α τ ι κ ο ́ ς « qui sert de thème grammatical » , dér. de θ ε ́ μ α, v.  thème <sup 1</sup . 
thalle|Empr. au lat. d'époque impériale thallus « tige d'une plante garnie de feuilles ».
thane|Empr. à l'angl. thane  att. sous cette forme dep. le  xvi <sup e</sup s. et issu du vieil angl. þeʒn , þeʒen  « disciple, serviteur, membre d'une escorte, guerrier » d'où « occupant d'une terre du suzerain pour ses faits de guerre », sens corresp. alors, en Angleterre et en Écosse, à un titre de noblesse; cependant  thanes  est resté uniquement comme terme hist. en Angleterre au profit de  knight  ou  baron  qui s'imposèrent au  xii <sup e</sup s., alors qu'il est resté dans l'usage en Écosse . 
thaumaturge|Empr. au gr. θ α υ μ α τ ο υ ρ γ ο ́ ς « celui qui fait des tours d'adresse » à l'époque chrét. « celui qui fait des miracles », comp. de θ α υ ̃ μ α, -α τ ο ς « objet d'étonnement ou merveilleux » d'où au plur. τ α ̀ θ α υ ́ μ α τ α « tour de force, d'adresse » et de ε ́ ρ γ ο ν « l'action ». 
thallium|Empr. à l'angl. thallium , nom donné au corps simple isolé par le chimiste W. Crookes en 1861 , dér. du gr. θ α λ λ ο ́ ς « jeune pousse » , le spectre de ce métal étant caractérisé par une raie verte. 
thaumaturgie|Empr. au gr. θ α υ μ α τ ο υ ρ γ ι ́ α « art de faire des tours d'adresse » à l'époque chrét. « action de faire des miracles », dér. de θ α υ μ α τ ο υ ρ γ ο ́ ς v.  thaumaturge ;  cf.  aussi l'angl.  thaumaturgy  att. dès 1727 ds  NED .
thème|Empr. au lat. d'époque impériale thema  « thème, proposition, sujet, thèse; thème de nativité, horoscope », empr. au gr. θ ε ́ μ α « ce qu'on dépose » d'où « thème, sujet de développement », de τ ι ́ θ η μ ι « poser ». 
thébaïde|Empr. au lat. Thebais, -idis , dér. de  Thebae  « Thèbes, ville de Haute-Égypte » . 
thénar|Empr. au gr. θ ε ́ ν α ρ « partie déprimée d'une surface, creux » en partic. « creux ou paume de la main ».
thébaïque|Empr. au lat. Thebaicus  et celui-ci au gr. θ η β α ι ̈ κ ο ́ ς « de Thèbes », dér. de Θ η ̃ β α ι « Thèbes », ville d'Égypte qui était autrefois un important centre du commerce de l'opium.  Cf.  a. fr.  thebaic  , angl.  thebaic extract  ; fr.  opium de Thèbes  .
théorétique|Empr. au b. lat. theoreticus  « spéculatif », gr. θ ε ω ρ η τ ι κ ο ́ ς «  id.  » de θ ε ω ρ η τ ι κ ο ́ ς « observer, contempler ». 
thériaque|Empr. au lat. méd. theriaca  « même sens », gr. θ η ρ ι α κ η ́ fém. subst. de l'adj. θ η ρ ι α κ ο ́ ς « qui concerne les bêtes sauvages, bon contre les morsures des bêtes sauvages », dér. de θ η ρ ι ́ ο ν « bête féroce ou sauvage ».
théocratie|Empr. au gr. θ ε ο κ ρ α τ ι ́ α « gouvernement de Dieu, théocratie », mot qui semble avoir été créé au I<sup er</sup s. par l'historien Flavius Josèphe . 
théridion|Empr. au gr. θ η ρ ι ́ δ ι ο ν « petite bête sauvage », dimin. de θ η ρ ι ́ ο ν « bête sauvage ». 
théorie|Empr. au b. lat. theoria « la spéculation, la recherche spéculative », empr. au gr. θ ε ω ρ ι ́ α, de θ ε ω ρ ε ι ̃ ν « observer, contempler »; comme terme de philos., a remplacé  théorique *. 
théorique|Empr. au b. lat. theoricus  « spéculatif » du gr. θ ε ω ρ ι κ ο ́ ς «  id.  », empl. subst. par la scolast., est empr. dans la lang. sav.  et le développement des sciences appliquées entraîne un usage adj. . 
théodolite|Empr. à l'angl. theodolite , forme altérée de  theodelite , terme d'orig. inc. prob. créé par Digges qui l'att. en 1571 sous la forme latinisée  theodelitus  . La forme angl.  theodolite  est att. d'abord par les var.  theodolit  en 1669,  theodolet  en 1701 ds  NED  et  theodolite  ds  Harris ,  Lexicon Technicum, or an universal English dict. of Arts and Sciences , vol. I, 2<sup e</sup éd., London, 1708 [et ds 1<sup re</sup éd. 1704 d'apr.  Littré Add.  1872].
théogonie|Empr. au gr. θ ε ο γ ο ν ι ́ α « naissance, origine, généalogie des dieux », titre d'un poème d'Hésiode sur l'histoire des générations divines et la naissance de l'univers depuis le chaos initial . 
théophanie|Empr. au gr. θ ε ο φ α ν ι ́ α « fêtes des théophanies à Delphes » ; dans la lang. chrét. « manifestation de Dieu » , v.  Bailly ,  Liddell - Scott ; lat. chrét.  theophania  « épiphanie » , « manifestation divine » , de là, le terme pop. a. fr.  tifaine  . 
thermes|Empr. au lat. thermae  « thermes, bains d'eaux chaudes ». 
théosophe|Empr. au lat. médiév. theosophus  « qui a une grande connaissance des choses divines » 999;  xi <sup e</sup s.,  Hugues de Flavigny  ds  Du Cange , gr. θ ε ο ́ σ ο φ ο ς « instruit des choses divines » . 
théosophie|Empr. au gr. tardif θ ε ο σ ο φ ι ́ α propr. « connaissance des choses divines » . 
thèque|Empr. au gr. θ η ́ κ η « boîte où l'on dépose quelque chose », « coffre, caisse ».
thérapeute|Empr. au gr. θ ε ρ α π ε υ τ η ́ ς « qui prend soin », « celui qui prend soin du corps », d'où « celui qui soigne les malades, médecin ». 
théologie|Empr. au lat. theologia  « étude, science des dieux, mythologie » ; dans la lang. chrét. « science, étude de Dieu » , « théodicée, étude de la divinité basée sur la raison » ; au Moy. Âge « doctrine théologique »  theologia Spiritus Sancti  , « explication rationnelle du Révélé » . Le lat. est empr. au gr. θ ε ο λ ο γ ι ́ α « recherche sur la divinité, les choses divines; science de la divinité » ; dans la lang. chrét. « doctrine de la divinité de J.-C. » . 
thérapeutique|Empr. au gr. θ ε ρ α π ε υ τ ι κ ο ́ ς « qui prend soin de », « qui concerne le soin qu'on prend de quelqu'un ou de quelque chose » et subst. θ ε ρ α π ε υ τ ι κ η ́ « l'art de prendre soin ». 
théorbe|Empr. à l'ital. tiorba  « sorte de grand luth à deux manches » , aussi  teorba  ; cet instrument aurait été inventé en 1575 par Antonio Naldi, musicien toscan dit  il Bardella  ;  tiorba  est d'orig. incertaine: G.  Alessio et à sa suite  DEI , estiment que la forme originelle était  tuorba , appartenait au vénit. et non au tosc., et le rattachent au sl.  torba , att. en Istrie et Dalmatie au sens de « besace », du turc  torba  «  id.  », mais cette hyp. est réfutée à juste titre par A.  Prati  ds  R. Ling. rom.  t. 19, pp. 213-214; v. aussi  Cor. - Pasc. ,  s.v. tiorba . 
théologique|Empr. au lat. eccl. theologicus « qui concerne la théologie » , « théologal » ; gr. θ ε ο λ ο γ ι κ ο ́ ς « qui concerne la connaissance de Dieu » . 
thérapie|Empr. au gr. θ ε ρ α π ε ι ́ α « entretien, traitement », « soin du corps, soins médicaux, traitements », « préparation d'un remède »; le sens 2 a été repris de l'all.  therapie , angl.  therapy . 
théorème|Empr. au lat. d'époque impériale theorema  « proposition », gr. θ ε ω ́ ρ η μ α « ce qu'on peut contempler; objet d'étude et de méditation », dér. de θ ε ω ρ ε ι ̃ ν « observer, contempler ». 
thlaspi|Empr. au lat. impérial thlaspi , de même sens, gr. θ λ α ́ σ π ι, θ λ α ́ σ π ι ς «  id.  » . 
thomise|Empr. au lat. sc. thomisus  , dér. du lat.  thomix  « corde de chanvre », gr. θ ω ̃ μ ι γ ξ « corde d'arc, fil de lin ». 
thésauriser|Empr. au lat. chrét. thesaurizare  « amasser  », dér. de  thesaurus  « trésor » . 
thiase|Empr. au lat. thiasus  « thiase, danse en l'honneur de Bacchus », « cortège », gr. θ ι ́ α σ ο ς « troupe de gens ou confrérie célébrant des rites en l'honneur d'un Dieu, particulièrement Dionysos et parcourant les rues en dansant, chantant, criant », « troupe bruyante », « la fête elle-même, danse, festin ».
thonaire|Empr. au prov. tonaira , de même sens ,  tonaire .
thonnaire|Empr. au prov. tonaira , de même sens ,  tonaire .
thèse|Empr. au lat. thesis  « sujet, proposition, thème », gr. θ ε ́ σ ι ς « action de poser, de placer; convention;  action de poser une thèse, proposition ». 
thora|Empr. à l'hébr. biblique tōrā <sup  h </sup « instruction, enseignement, doctrine; loi, la Loi de Moïse  », nom verbal de  hōrā <sup  h </sup « montrer, indiquer; diriger, enseigner, instruire », forme hiphil  de  yārā <sup  h </sup « jeter, lancer ». 
thesmophories|Empr. au lat. Thesmophoria  « même sens », gr. θ ε σ μ ο φ ο ́ ρ ι α « fêtes célébrées du 9 au 13 novembre en l'honneur de Déméter », dér. de θ ε σ μ ο φ ο ́ ρ ο ς « qui apporte des lois, qui civilise », épith. de Déméter.
thoracique|Empr. au gr. θ ω ρ α κ ι κ ο ́ ς « du thorax, de la poitrine » ; au sens 2  cf.  lat. sc.  thoracici  . 
thesmothète|Empr. au gr. θ ε σ μ ο θ ε ́ τ η ς «  archonte thesmothète », littéral. « celui qui propose les lois ».
thète|Empr. au gr. θ η ́ ς, θ η τ ο ́ ς « travailleur salarié », qui a désigné dans la législation de Solon la dernière classe des citoyens athéniens.
thrombose|Empr. au gr. θ ρ ο ́ μ β ω σ ι ς « coagulation  », dér. de θ ρ ο ́ μ β ο ς « caillot d'un liquide coagulé ». II par l'intermédiaire de l'all. .
thorax|Empr. au lat. thorax  « cuirasse » puis « poitrine, tronc » . 
thrène|Empr. au b. lat. threnus  « chant funèbre, complainte » , transcrivant le gr. θ ρ η ̃ ν ο ς de même sens;  cf.  au  xiii <sup e</sup s.  treny  . 
thréonine|Empr. à l'angl. threonine  att. en 1956 -threonine , parallèlement à  d-threose , v.  NED Suppl. <sup 2</sup ) formé du suff.  -ine et de  threose  .
thuriféraire|Empr. au lat. médiév. turiferarius dér. du lat.  turifer  « qui offre l'encens aux faux dieux », comp. de  tus  « encens » et  fero  « porter ». 
thriller|Empr. à l'angl. thriller  « œuvre à sensations, qui émeut ou donne le frisson »  dér. de  to thrill  au sens de « provoquer une sensation de frisson, émouvoir, faire frémir ». 
thyade|Empr. au lat. Thyiades  plur. de  Thyas , lui-même empr. au gr. θ υα ́ ς, -α ́ δ ο ς « furieux; Bacchante » de θ υ ́ ω « bondir, s'élancer avec fureur ». 
thylacine|Empr. au lat. sc. thylacinus 60 ds  Neave ), mot créé à partir du gr. θ υ ́ λ α κ ο ς « sac formé par la peau d'une bête vidée ». 
thym|Empr. au lat. thymum , lui-même empr. au gr. θ υ ́ μ ο ν, forme dorique de θ υ ́ μ ο ς « espèce de sarriette », et qui chez Pline a été utilisé pour désigner, en Gaule, le thym. 
thyrse|Empr. au lat. thyrsus  « tige des plantes », « thyrse de Bacchus », empr. poét. et techn. au gr. θ υ ́ ρ σ ο ς « bâton des Bacchantes, enveloppé de lierre et pourvu d'une pomme de pin à l'extrémité ». 
thyroïde|Empr. au gr. θ υ ρ ε ο ε ι δ η ́ ς propr. « semblable à un bouclier long », comp. de θ υ ρ ε ́ ο ς « bouclier long », à l'orig. « grosse pierre servant de porte » ) et de ε ι ̃ δ ο ς « la forme, l'apparence », θ υ ρ ε ο ε ι δ η ́ ς servant à désigner le cartilage scutiforme du larynx; souvent écrit θ υ ρ ο ε ι δ η ́ ς « semblable à une porte »; d'où la forme du fr.  Littré  a tenté sans succès de rectifier le mot fr. en  thyréoïde . 
